abacinat: vc; 'abacinate' 
abas: vc;annoy quantChg vt 'abase' 
abashe: vc;noKnowledge vt 'abash' 
abat: vc;VI lessC pt vt 'abate' 
abbreviat: vc;VNPPP VNPPPas chgAttr chgQuant vt 'abbreviate' 
abdicat: vc;VNPPP VPPas give 'abdicate' 
abduc: vc; 'abduce' 
aberrat: vc;vt 'aberrate' 
abett: vc;VNPNGoc VNPPNGoc VNPPP VhisNG enDo vt 'abet' 
abhorr: vc;VHOWSS VPPforTO VTH VhisNG emph hate passion vt vtoV 'abhor' 
abid: nc vc;VPP VhisNG undergo vt 'abide' 
abjur: vc;VNPPP enHidden give 'abjure' 
ablactat: vc;act vt 'ablactate' 
ablat: vc;looksChg vt 'ablate' 
abnegat: vc;give vt 'abnegate' 
abolishe: vc;VhisNG enHidden perOrgV remove 'abolish' 
abominat: vc;VTH VhisNG hate vt 'abominate' 
abrad: vc;chgForm sequence 'abrade' 
abras: vc; 'abrase' 
abridg: vc;produce vt 'abridge' 
abrogat: vc;enHidden 'abrogate' 
abscis: vc;vt 'abscise' 
absolv: vc;VNPPP chgIsa vt 'absolve' 
absquatulat: vc; 'absquatulate' 
abutt: vc;VIrecip VPP tie 'abut' 
acced: vc;VPP pAttitude 'accede' 
accelerat: vc;VHOWSS VI VNPPP VPP VhisNG chgMeasure moreC vt 'accelerate' 
accentuat: vc;VTH VhisNG vt 'accentuate' 
accesse: vc;Key VerbNom vacTo vt 'access' 
acclimat: vc;VNPPP VPP VhisNG 'acclimate' 
acclimatis: vc;VNPPP VPP VhisNG suit vt 'acclimatise' 
acclimatiz: vc;VNPPP VPP VhisNG suit 'acclimatize' 
accommodat: vc;VI VNPPP VPP VhisNG pt vt 'accommodate' 
accompani: vc;VNPPP chase vt whileAway 'accompany' 
accompanie: vc;VNPPP chase vt whileAway 'accompany' 
accomplishe: vc;mkBetter succeed vt 'accomplish' 
accret: vc;vt 'accrete' 
accru: vc;VI VPP moreC quantChg vt 'accrue' 
acculturat: vc;vt 'acculturate' 
accumulat: vc;move quantChg take 'accumulate' 
accurs: vc; 'accurse' 
accus: vc;VNPPNGoc VNPPP blame perOrgV vt 'accuse' 
acerbat: vc; 'acerbate' 
acetifi: vc;chgAttr 'acetify' 
acetifie: vc;chgAttr 'acetify' 
acetylat: vc;vt 'acetylate' 
acetylis: vc; 'acetylise' 
ach: vc;VI ill needForW perOrgV vi volition 'ache' 
achiev: vc;pt vacVO vt 'achieve' 
achromatis: vc; 'achromatise' 
acid-washe: vc;clean hyphenated 'acid-wash' 
acidifi: vc;chgAttr vt 'acidify' 
acidifie: vc;chgAttr vt 'acidify' 
acidulat: vc;chgAttr 'acidulate' 
acknowledg: vc;VNG VNPNP VNPPNGoc VNPPP VNPPPas VNPTObe VPPTH VSS VTH VWHSS express pEmo tWord vt 'acknowledge' 
acquiesc: vc;VI VPP VPhisNG pAttitude vi 'acquiesce' 
acquir: vc;VNPPP VNPPPPP useC vt 'acquire' 
acquitt: vc;VNPPP chgIsa express vt 'acquit' 
activat: vc;chgState promoteW vt 'activate' 
actualis: vc;mkBetter vt 'actualise' 
actualiz: vc;mkBetter vt 'actualize' 
actuat: vc;enDo vt 'actuate' 
ad-libb: vc;abstract hyphenated vt 'ad-lib' 
addl: vc;sequence vt 'addle' 
adduc: vc;express vt 'adduce' 
adher: vc;VNPPP VPP chgFit connect 'adhere' 
adjudg: vc;VNPTObe VTH dative express vt 'adjudge' 
adjudicat: vc;VPP VPPNG VPhisNG decide 'adjudicate' 
adjur: vc;VNPTOoc enDo vt 'adjure' 
adlibb: ;v 'adlib' 
admeasur: vc;enDo 'admeasure' 
administrat: vc;control 'administrate' 
admir: vc;fondOf pEmo pt vt 'admire' 
admitt: vc;VNG VNPAP VNPPP VPNGsc VPP VPPTH VSS VTH chgInclude express tWord vVing vt 'admit' 
admixe: vc;VIrecip VPP tie vt 'admix' 
admonishe: vc;VNPPP VNPPhisNG nAttitude vtPer 'admonish' 
ador: vc;VNG VPPforTO emph fondOf love passion vt vtoV 'adore' 
adulat: vc;please 'adulate' 
adulterat: vc;VNPPP quality vt 'adulterate' 
adumbrat: vc;beC vt 'adumbrate' 
advanc: vc;VNPPP VNPPPas VPP VPPdir VerbNom dative n promoteW statePhy vacP vacTo xiangV 'advance' 
advantag: vc;abstract prod0 superiority up v 'advantage' 
adventur: vc;VI abstract v 'adventure' 
advertis: vc;VNPPP VNPPPas VPP VPPforTO VPPhowTO VTH VhisNG express perOrgV vtoV 'advertise' 
advertiz: vc;VNPPP VNPPPas VPP VPPforTO VPPhowTO VTH VhisNG express perOrgV vt vtoV 'advertize' 
advis: vc;VI VNPPP VNPPhisNG VNPSS VNPTOoc VPP VPhisNG VSS VhisNG express perOrgV tWord vtPer 'advise' 
advocat: vc;VNPPPas VhisNG count orgHN per vt 'advocate' 
aerat: vc;chgLooks metabolize 'aerate' 
aerifi: vc;chgQuant 'aerify' 
aerifie: vc;chgQuant 'aerify' 
aerosolis: vc; 'aerosolise' 
aestivat: vc;rest vt 'aestivate' 
affianc: vc;VNPPP vt 'affiance' 
affiliat: vc;VNPPP VPP orgHN 'affiliate' 
affixe: vc;VNPPP VPP abstract component count vt 'affix' 
agglomerat: vc;chgLooks looksChg 'agglomerate' 
agglutinat: vc;VNPPP VPP connect vt 'agglutinate' 
aggrad: vc; 'aggrade' 
aggrandiz: vc;express quantChg vt 'aggrandize' 
aggravat: vc;aggravateW vt 'aggravate' 
aggregat: vc;VI VIrecip VNPPP VPP VerbNom artifact count quant vt 'aggregate' 
aggresse: vc;VPP mkBad 'aggress' 
aggriev: vc;vt 'aggrieve' 
agitat: vc;VPP VPPforTO aggravateW chgEmo mkBad vtoV 'agitate' 
agnis: vc;know 'agnise' 
agniz: vc;know 'agnize' 
agoniz: vc;nEmo 'agonize' 
air-dri: A vc;a chgMeasure hyphenated 'air-dry' 
air-drie: A vc;a chgMeasure hyphenated 'air-dry' 
air-dropp: vc;hyphenated moveDown 'air-drop' 
airdropp: vc;abstract v 'airdrop' 
alchemis: vc; 'alchemise' 
alcoholis: vc;chgAttr 'alcoholise' 
alcoholiz: vc;chgAttr 'alcoholize' 
alienat: vc;VNPPP chgConnect chgPoss vt 'alienate' 
alin: vc;associate chgCompare 'aline' 
alkalifi: vc;chgAttr 'alkalify' 
alkalifie: vc;chgAttr 'alkalify' 
alkalinis: vc; 'alkalinise' 
alleg: vc;VNPTObe VSS VTH attack blame vt 'allege' 
allegoris: vc; 'allegorise' 
alleviat: vc;chgProperty correctW vt 'alleviate' 
alli: vc;VNPPP VPP count natural orgHN per 'ally' 
allie: vc;VNPPP VPP count natural orgHN per 'ally' 
alliterat: vc;vt 'alliterate' 
allocat: vc;VNPPP VPP control dative give vt 'allocate' 
allott: vc;VNPPPfor VNPPhisNG dative give vt 'allot' 
allud: vc;VPP VPPNG VPhisNG mkOthersKnowledge 'allude' 
alphabetis: vc;enMove vt 'alphabetise' 
alphabetiz: vc;enMove vt 'alphabetize' 
altercat: vc; 'altercate' 
alternat: A;VI VIrecip VNPPP VPP ebla sequence vt 'alternate' 
amalgamat: vc;VI VIrecip VNPPP VPP tie 'amalgamate' 
amasse: vc;move take vt 'amass' 
amaz: vc;emph passion pred vtPer 'amaze' 
ambl: vc;VI abstract count vi 'amble' 
ambulat: vc;tie vt 'ambulate' 
ambushe: vc;group nt vt 'ambush' 
ameliorat: vc;correctW mkBetter 'ameliorate' 
amerc: vc;mkBad vt 'amerce' 
americanis: vc; 'americanise' 
ammoniat: vc;artifact 'ammoniate' 
ammonifi: vc;chgAttr vt 'ammonify' 
ammonifie: vc;chgAttr vt 'ammonify' 
amplifi: vc;VPP chgMeasure moreC vt 'amplify' 
amplifie: vc;VPP chgMeasure moreC vt 'amplify' 
amputat: vc;chgForm 'amputate' 
amus: vc;happy vt 'amuse' 
anaesthetiz: vc;mkAct vt 'anaesthetize' 
analogie: nc;abstract info 'analogy' 
analogiz: vc;think 'analogize' 
analys: vc;VNPPP VWHSS VhisNG tryToKnow vt 'analyse' 
analyz: vc;VHOWSS VNPPP VPPhowTO VTH VWHSS VhisNG infoV tryToKnow vt 'analyze' 
anastomos: vc;suit 'anastomose' 
anatomis: vc;chgForm 'anatomise' 
anatomiz: vc;chgForm 'anatomize' 
ancylos: vc;ill 'ancylose' 
anel: vc; 'anele' 
anesthetiz: vc;mkAct vt 'anesthetize' 
angl: vc;VNPPP VPP count measure vt 'angle' 
anglicis: vc;VNPPP VPP chgAttr vt 'anglicise' 
angliciz: vc;VNPPP VPP chgAttr vt 'anglicize' 
angulat: A ac; 'angulate' 
animalis: vc;vt 'animalise' 
animat: A;situation vt 'animate' 
animis: vc; 'animise' 
ankylos: vc;ill 'ankylose' 
annihilat: vc;remove vt 'annihilate' 
annotat: vc;express 'annotate' 
announc: vc;VNPPP VNPPPas VPPTH VPPhowTO VSS VTH VWHSS express infoV perOrgV vt 'announce' 
annull: vc;causeNotDo enHidden 'annul' 
annunciat: vc;VNPPP VPPTH VPPhowTO VTH VWHSS express vt 'annunciate' 
antagonis: vc;aggravateW vtPer 'antagonise' 
antagoniz: vc;remove 'antagonize' 
anteced: vc;statePhy vt 'antecede' 
antedat: vc;chgLoc statePhy timeOrSpace vt 'antedate' 
antibodie: nc;component 'antibody' 
anticipat: vc;VNPNGoc VNPPP VNPTO VSS VTH VWHSS VhisNG deduce take vVing vt 'anticipate' 
antiquat: vc; 'antiquate' 
apologie: nc;VerbNom nt 'apology' 
apologis: vc;vi 'apologise' 
apologiz: vc;VI VPP VPPNG VPPPP VPhisNG VTH troubleW vi 'apologize' 
apotheos: vc; 'apotheose' 
appeas: vc;mkBad mkBetter vt 'appease' 
apperceiv: vc;vt 'apperceive' 
appli: vc;VNPPP VNPTOsc VPNGsc VPP VPPPP VPPforTO act pt vacVO vtoV 'apply' 
applie: vc;VNPPP VNPTOsc VPNGsc VPP VPPPP VPPforTO act pt vacVO vtoV 'apply' 
appliqu: vc;artifact vt 'applique' 
appos: vc;vt 'appose' 
apprais: vc;mkOwnKnowledge vt 'appraise' 
appreciat: vc;VHOWSS VI VNPNGoc VNPPP VPP VTH VWHSS VhisNG love passion vVing vt weakPI 'appreciate' 
appris: vc;VNPPP VNPSS express vt 'apprise' 
appriz: vc;express 'apprize' 
approache: vc;Nom VNPAP VNPPP VNPPhisNG VNPTOoc VPP VPPforTO count tech up vt vtoV 'approach' 
approbat: vc;VI vt 'approbate' 
approv: vc;VI VNPPP VNPPhisNG VNPTOoc VPP VPPNG VPhisNG VhisNG pAttitude pEmo perOrgV pt vt 'approve' 
approximat: A;APP VI VNPPP VNPTObe VPP content situation vt 'approximate' 
aquaplan: vc;VI count tool vi 'aquaplane' 
arbitrat: vc;VI VPP decide persuade 'arbitrate' 
archais: vc;study 'archaise' 
archaiz: vc;study 'archaize' 
archiv: vc;count v 'archive' 
argu: vc;VI VIrecip VNPPNGoc VNPPP VPP VPPNG VPPPP VPhisNG VSS VTH VWHSS communicate haveKnowledge needForW perOrgV vt 'argue' 
argufi: vc;enDo 'argufy' 
argufie: vc;enDo 'argufy' 
aris: vc;VI VPP VPPas appear moreC move vi 'arise' 
armie: nc;component count orgHN 'army' 
aromatis: vc;enMove 'aromatise' 
aromatiz: vc;enMove 'aromatize' 
arous: vc;CR think vt 'arouse' 
arrang: vc;VHOWSS VNPPP VPP VPPforTO VPhisNG VTH VhisNG control decide mkBetter perOrgV vt vtoV 'arrange' 
arriv: vc;VI VPP VRB ceaseMove vi 'arrive' 
arrogat: vc;VNPPP enBe 'arrogate' 
arsewip: vc;curse 'arsewipe' 
arterialis: vc; 'arterialise' 
articulat: A vc;VNPPP content 'articulate' 
ascrib: vc;VNPPP express vt 'ascribe' 
aspers: vc;playDown vt 'asperse' 
asphyxiat: vc;causeNotDo ill 'asphyxiate' 
aspir: vc;VI VPP mkOwnKnowledge needForW vtoV 'aspire' 
aspirat: A vc;abstract count vt 'aspirate' 
assassinat: vc;mkBad nt perOrgV vtPer 'assassinate' 
assembl: vc;VIrecip VPP move store tie 'assemble' 
assesse: vc;VHOWSS VNPPP VNPPPas VNPasAP VWHSS check vt 'assess' 
asseverat: vc;VTH vt 'asseverate' 
assibilat: vc;vt 'assibilate' 
assimilat: vc;VNPPP VPP chgAttr metabolize mkOwnKnowledge 'assimilate' 
associat: A nc vc;VI VIrecip VNPPP VPP count per 'associate' 
assonat: vc;vt 'assonate' 
assuag: vc;chgEmo chgProperty correctW vt 'assuage' 
assum: vc;VNPEN VNPPPas VNPTObe VSS VTH bear vt 'assume' 
assur: vc;VNPNP VNPPP VNPPhisNG VNPSS VSS VTH pt vt 'assure' 
astonishe: vc;nEmo vtPer 'astonish' 
astrogat: vc; 'astrogate' 
atomis: vc;chgAttr vt 'atomise' 
atomiz: vc;chgAttr vt 'atomize' 
aton: vc;VPP improve 'atone' 
attenuat: A vc;chgProperty quantChg vt 'attenuate' 
attitudiniz: vc;VI demeanor 'attitudinize' 
attribut: vc;VNPPP VNPPhisNG count tWord vt 'attribute' 
attun: vc;VNPPP situation 'attune' 
aurifi: vc; 'aurify' 
aurifie: vc; 'aurify' 
auscultat: vc;thinking vt 'auscultate' 
auspicat: vc; 'auspicate' 
authenticat: vc;VNPPPas VTH VWHSS tWord tryToKnow vt 'authenticate' 
authoris: vc;VNPPP VNPPPas VNPTOoc VhisNG tWord vt 'authorise' 
authoritie: nc;Nom abstract onV orgHN per property vtoV 'authority' 
authoriz: vc;VNPPP VNPPPas VNPTOoc VhisNG pEmo tWord vt 'authorize' 
autobiographie: nc;abstract count 'autobiography' 
autoclav: vc;prod v 'autoclave' 
automatis: vc; 'automatise' 
autopsi: vc;count v 'autopsy' 
autopsie: vc;count v 'autopsy' 
aveng: vc;VNPPP mkBad vt 'avenge' 
avianis: vc; 'avianise' 
aviat: vc;vt 'aviate' 
avouche: vc;pEmo 'avouch' 
avuls: vc;vt 'avulse' 
awak: A vc;APP perF pred vi 'awake' 
babbl: vc;VPP abstract nt vt 'babble' 
babie: nc;count relatives vt 'baby' 
baby-sitt: vc;enGrow hyphenated 'baby-sit' 
babysitt: vc;VPP vt 'babysit' 
backfir: vc;VI count vi 'backfire' 
backpedall: vc;VI VPP 'backpedal' 
backslapp: vc; 'backslap' 
backspac: vc;VI tool v 'backspace' 
backstabb: vc; 'backstab' 
backstitche: ;v 'backstitch' 
backstopp: ;v 'backstop' 
backstrok: vc;count v 'backstroke' 
bacteris: vc; 'bacterise' 
baffl: vc;annoy artifact count passion vtPer weakPI 'baffle' 
bagg: vc;VNPPP animal count prod tool vt 'bag' 
bak: vc;VNPPPfor chgMeasure produce vt 'bake' 
balanc: vc;VNPPP VPP artifact content quant vt 'balance' 
balkanis: vc; 'balkanise' 
ballyragg: nc vc;annoy 'ballyrag' 
bamboozl: vc;vt 'bamboozle' 
bandi: A;VNPPP component vt 'bandy' 
bandie: A;VNPPP component vt 'bandy' 
banishe: vc;VNPPP expel vt 'banish' 
bann: vc;VNPPP VerbNom count remove troubleW vt 'ban' 
baptis: vc;pAttitude 'baptise' 
baptiz: vc;VNPPP VNPPPas pAttitude vt 'baptize' 
barbaris: vc;vt 'barbarise' 
barbecu: vc;VNPPP produce vt 'barbecue' 
barg: vc;VPP count tool vt 'barge' 
barr: vc;VNPPNGoc VNPPPas VhisNG artifact count dative remove vt 'bar' 
barricad: vc;VNPPP artifact count vt 'barricade' 
bas: vc;APP ATH AitPPforTO VNPPP VNPPhisNG artifact component count standard 'base' 
bashe: vc;VNPPP abstract count troubleW 'bash' 
basifi: vc;chgAttr 'basify' 
basifie: vc;chgAttr 'basify' 
bastardis: vc;vt 'bastardise' 
battl: vc;VI VIrecip VPP VPPPP VerbNom act haveContest nt vt 'battle' 
beatifi: vc;pEmo vt 'beatify' 
beatifie: vc;pEmo vt 'beatify' 
beautifi: vc;chgLooks improve vt 'beautify' 
beautifie: vc;chgLooks improve vt 'beautify' 
becom: vc;linkV vAP 'become' 
bedazzl: vc; 'bedazzle' 
bedraggl: vc; 'bedraggle' 
befitt: vc;suit vt 'befit' 
befogg: vc;mkAct 'befog' 
befuddl: vc;attack chgKnow vtPer 'befuddle' 
begg: vc;VNPPP VNPTOoc needForW perV seek vt 'beg' 
beginn: vc;VNG VNPPP VNPPPas VPNGsc VPP VPPNG VPPas act statePhy vVing vtoV 'begin' 
begrim: vc;chgLooks 'begrime' 
begrudg: vc;dative 'begrudge' 
beguil: vc;VNPPP VNPPhisNG improve vt 'beguile' 
behav: vc;VI VPP VRB act vi 'behave' 
behoov: vc; 'behoove' 
behov: vc;quality 'behove' 
belche: vc;VerbNom count statePhy 'belch' 
beli: vc;mkNoKnowledge vt 'belie' 
believ: vc;VNPAP VNPTObe VPP VPhisNG VSS VTH haveKnowledge perOrgV vt 'believe' 
belittl: vc;VhisNG attack chgProperty vtPer 'belittle' 
belly-flopp: vc;hyphenated whileAway 'belly-flop' 
bellyach: vc;VI VPP VTH vi 'bellyache' 
belov: vc; 'belove' 
bemus: nc vc;annoy chgKnow vtPer 'bemuse' 
benche: vc;count prod tool v 'bench' 
benefitt: vc;Nom VPP VPPPP abstract effectivity improve superiority vacOf vt 'benefit' 
bereav: vc;VNPPP collect vt 'bereave' 
berrie: nc;plant 'berry' 
beseeche: vc;VNPTOoc enDo vt 'beseech' 
besett: vc;VBDN attack negAdj vt 'beset' 
besieg: vc;VNPPP attack coil mkBad vt 'besiege' 
besmirche: vc;annoy playDown vt 'besmirch' 
bespeckl: vc; 'bespeckle' 
besprinkl: vc; 'besprinkle' 
bestialis: vc; 'bestialise' 
bestirr: vc;VNPPP enDo vt 'bestir' 
bett: vc;VBDN VI VNPNP VNPPP VPP VPPPP VSS VTH VerbNom count perF vAP vt 'bet' 
bevell: vc;component count vt 'bevel' 
bewar: vc;VHOWSS VPP VTH VhisNG perF vt 'beware' 
bewitche: vc;enDo vt 'bewitch' 
bicycl: vc;VI VPP VPPPP VPPdir count prod tool 'bicycle' 
bidd: nc vc;VBDN VI VNPPP VNPRB VNPTOoc VPP VPPPP VRB VerbNom count dative price vt vtoV 'bid' 
bifurcat: vc;looksChg 'bifurcate' 
bilg: vc;component 'bilge' 
biodegrad: vc;chgProperty 'biodegrade' 
bituminis: vc; 'bituminise' 
blabb: vc;VPP VPPPP VPPTH VTH mkMisunderstand vt 'blab' 
blackberrie: nc;plant 'blackberry' 
blacklegg: vc;count per vt 'blackleg' 
blam: vc;VNPPNGoc VNPPP VNPPhisNG blame hate nt passion vt weakPI 'blame' 
blar: vc;VPP abstract vt 'blare' 
blasphem: vc;chgProperty nt vt 'blaspheme' 
blatt: vc;mkSound 'blat' 
blaz: vc;VNPPP count natural vt 'blaze' 
bleache: vc;VNPAP chgLooks vt 'bleach' 
blenche: A;VI VPP nt vi 'blench' 
blesse: vc;help pEmo perOrgV vt 'bless' 
blipp: vc;VNPPP VPP VerbNom count 'blip' 
blogg: vc;abstract per v 'blog' 
blott: vc;count natural vt 'blot' 
blubb: vc;nEmo 'blub' 
blueberrie: nc;plant 'blueberry' 
blurr: vc;abstract count natural vt 'blur' 
blushe: vc;VI VPP color stateMental v 'blush' 
boat-rac: vc;count hyphenated 'boat-race' 
bobb: vc;VPP count currency per0 vt 'bob' 
bobbl: vc;abstract v 'bobble' 
bobsledd: vc;count tool v 'bobsled' 
bodg: vc;mkBad 'bodge' 
bodie: nc;bodyPart component looks 'body' 
bogg: vc;count vt 'bog' 
boggl: vc;VPP nt vt 'boggle' 
boldfac: A vc;looks 'boldface' 
bollixe: vc;mkBad 'bollix' 
bolshevis: vc; 'bolshevise' 
boogi: vc;abstract count v 'boogie' 
bootstrapp: vc;tool v 'bootstrap' 
booz: vc;VI prod vi 'booze' 
bopp: vc;abstract v 'bop' 
botche: vc;botchW count vt 'botch' 
bottl: vc;VNPPP VRB count prod 'bottle' 
bounc: vc;VI VPP VPPdir VerbNom prod0 vt 'bounce' 
bowdleris: vc;chgGood vt 'bowdlerise' 
bowdleriz: vc;chgGood vt 'bowdlerize' 
boxe: vc;VI component count tool vt 'box' 
brabbl: vc;communicate 'brabble' 
bragg: vc;VHOWSS VI VPP VPPPP VTH abstract nt vi 'brag' 
braill: vc;info 'braille' 
brainwashe: vc;VNPPP VNPPhisNG nt vt 'brainwash' 
brais: vc;VNPPP produce vt 'braise' 
brak: vc;VPP component count plant prod 'brake' 
brandishe: vc;VNPPP abstract vt 'brandish' 
breache: vc;VI VerbNom component nt statePhy vt 'breach' 
breaststrok: vc;count 'breaststroke' 
breez: vc;VI VPP count natural vi 'breeze' 
brevett: vc;abstract count 'brevet' 
brib: vc;VNPPP VNPTOoc VerbNom artifact count vt 'bribe' 
bridg: vc;VNPPP VerbNom artifact component count locUnit vt 'bridge' 
brimm: vc;VI component count v 'brim' 
bristl: vc;VI VPNGsc VPP component count prod v 'bristle' 
broache: vc;communicate vt 'broach' 
bromat: vc;chgAttr 'bromate' 
bromin: vc;artifact 'bromine' 
bruis: vc;VI VRB vt 'bruise' 
brushe: vc;VI VPP VRB count prod tWord tool vt 'brush' 
brutalis: vc;attack vtPer 'brutalise' 
brutaliz: vc;attack vtPer 'brutalize' 
buckl: vc;VI VPP component count prod vt 'buckle' 
budd: vc;component count 'bud' 
budg: vc;VPP 'budge' 
bulg: vc;VI VPP count looks v 'bulge' 
bulldoz: vc;VNPPP excite vt 'bulldoze' 
bulli: A;APP VNPPP VNPPhisNG annoy count curse per vt 'bully' 
bullie: A;APP VNPPP VNPPhisNG annoy count curse per vt 'bully' 
bullshitt: A;VNPPhisNG VPP abstract curse passion 'bullshit' 
bullyragg: vc;troubleW 'bullyrag' 
bumbl: vc;VNPPPdir VPPdir mkBad 'bumble' 
bumm: A vc;VI VNPPPfor attack curse 'bum' 
bundl: vc;VI count phy quant v 'bundle' 
bungl: vc;count 'bungle' 
burgl: vc;vt 'burgle' 
burglariz: vc;take 'burglarize' 
buri: vc;VNPPP VNPPPas enHidden move 'bury' 
burie: vc;VNPPP VNPPPas enHidden move 'bury' 
burk: vc;VNPPP refuse vt 'burke' 
burnishe: vc;abstract vt 'burnish' 
butterflie: vc;animal 'butterfly' 
buttresse: vc;VNPPP artifact count per promoteW vt 'buttress' 
by-passe: vc;artifact hyphenated v 'by-pass' 
bypasse: vc;VPP count vt 'bypass' 
cach: vc;VNPPP component count vt 'cache' 
cackl: vc;VI mkSound 'cackle' 
caddi: vc;artifact count v 'caddy' 
cadg: vc;VNPPP seek vt 'cadge' 
cajol: vc;VNPPNGoc VNPPP enDo 'cajole' 
calamitie: nc;nt phenomena 'calamity' 
calcifi: vc;chgAttr 'calcify' 
calcifie: vc;chgAttr 'calcify' 
calcimin: vc;tool v 'calcimine' 
calcin: vc;vt warmUp 'calcine' 
calculat: vc;VHOWSS VNPPP VNPPPPP VNPPPas VNPTOoc VPNGsc VPP VPPNG VSS VTH tryToKnow vt 'calculate' 
calibrat: vc;VNPPP calculate vt 'calibrate' 
calluse: vc;component 'callus' 
calumniat: A vc;annoy playDown vt 'calumniate' 
calv: vc;VI vt 'calve' 
camouflag: vc;VNPPP act artifact thinking vt 'camouflage' 
camphorat: vc;chgAttr 'camphorate' 
canaliz: vc;CR VNPPP vt 'canalize' 
cancell: vc;VI abstract perOrgV remove vt 'cancel' 
candie: nc;artifact vt 'candy' 
cano: vc;VPP count tool 'canoe' 
canonis: vc;vt 'canonise' 
canoodl: vc;chgForm 'canoodle' 
canvase: vc;artifact v 'canvas' 
canvasse: vc;VNPPP VPP vt 'canvass' 
capabilitie: nc;Nom VPPforTO abstract ebla pt solution vacOf vtoV 'capability' 
capacitat: vc; 'capacitate' 
capacitie: nc;Nom ebla measure vacOf vacVTO vtoV 'capacity' 
capitalis: vc;express vt 'capitalise' 
capitaliz: vc;VNPPP VPP express mkAct vt 'capitalize' 
capitulat: vc;VI VPP obey vi 'capitulate' 
capp: vc;VNPPP component count tool vt 'cap' 
capsiz: vc;enMove move 'capsize' 
capsulat: A vc;a enMove 'capsulate' 
capsulis: vc;enMove 'capsulise' 
capsuliz: vc;enMove 'capsulize' 
captivat: vc;VNPPP improve vt 'captivate' 
captur: vc;VNPAP VNPPP VerbNom possession prod0 vt 'capture' 
caramelis: vc; 'caramelise' 
carbonat: vc;artifact vt 'carbonate' 
carbonis: vc;chgAttr vt 'carbonise' 
carboniz: vc;chgAttr vt 'carbonize' 
carburis: vc; 'carburise' 
caresse: vc;count vt 'caress' 
carnalis: vc; 'carnalise' 
caroll: vc;VI abstract count vi 'carol' 
carous: vc;VI abstract metabolize pEmo vi 'carouse' 
carri: vc;VNPPPdir VNPRB abstract 'carry' 
carv: vc;VNPPP express vt 'carve' 
cascad: vc;VI VPP abstract count natural v 'cascade' 
cashe: vc;artifact vt 'cash' 
castigat: vc;VNPPP blame vtPer 'castigate' 
castrat: vc;enHidden 'castrate' 
catabolis: vc;chgConnect 'catabolise' 
cataboliz: vc;chgConnect 'catabolize' 
catalys: vc; 'catalyse' 
catalyz: vc;VNPPP VPP 'catalyze' 
catche: vc;VI VNPAP VNPNGoc VNPPP VPP VerbNom count tWord vt 'catch' 
categoriz: vc;VNPPP chgInclude vt 'categorize' 
catenat: vc;tie 'catenate' 
catheteris: vc;vt 'catheterise' 
catholicis: vc; 'catholicise' 
catnapp: vc;v 'catnap' 
caus: vc;VNPPPfor VNPTO VhisNG cause causeV nt vacOf vt 'cause' 
cauteris: vc;vt 'cauterise' 
cavill: vc;VPP abstract vt 'cavil' 
ceas: vc;VNG VPNGsc VPP abstract act count end vtoV 'cease' 
ced: vc;VNPPP give vt 'cede' 
celebrat: vc;pEmo pt vVing 'celebrate' 
celebritie: nc;count per prod0 'celebrity' 
centr: vc;VNPPP VPP component count onV orgHN vacOf 'centre' 
centralis: vc;chgAttr vt 'centralise' 
centraliz: vc;VNPPP chgAttr vt 'centralize' 
centurie: nc;count timeUnit 'century' 
certifi: vc;VNPAP VNPPP VNPPPas VNPTOoc VPPTH VSS VTH mkOwnKnowledge pEmo tWord vt 'certify' 
certifie: vc;VNPAP VNPPP VNPPPas VNPTOoc VPPTH VSS VTH mkOwnKnowledge pEmo tWord vt 'certify' 
challeng: vc;VI VNPPP VNPPPas VNPTOoc VSS VTH VerbNom perOrgV vt 'challenge' 
chanc: A vc;Nom abstract freq time vtoV 'chance' 
chandell: vc;abstract v 'chandelle' 
chang: vc;VNPPP VNPPPPP VNPPhisNG VPP VPPPP VerbNom chg statePhy tWord vacPTO 'change' 
channelis: vc;vt 'channelise' 
channell: vc;VNPPP VPP artifact count natural thinking vt 'channel' 
characteris: vc;chgAttr vt 'characterise' 
characteriz: vc;VNPPNGoc VNPPPas VNPasAP chgAttr vt 'characterize' 
charg: vc;VI VNPPNGoc VNPPP VNPPPas VNPTOoc VPP VPPPP VPPdir VTH VerbNom count dative vt 'charge' 
chas: vc;VNPPPdir VPP VerbNom count vt 'chase' 
chastis: vc;VNPPNGoc VNPPP VhisNG annoy blame mkBad perV vtPer 'chastise' 
chatt: vc;VIrecip VPP VPPPP VPhisNG count 'chat' 
checkmat: vc;abstract vt 'checkmate' 
cherishe: vc;VNPPP enLive feeling fondOf vt 'cherish' 
chican: vc;abstract v 'chicane' 
chim: vc;count prod 'chime' 
chisell: vc;VNPPP count prod tool vt 'chisel' 
chit-chatt: vc;communicate hyphenated 'chit-chat' 
chivvi: vc;approach vt 'chivy' 
chivvie: vc;approach vt 'chivy' 
chlorinat: vc;chgAttr vt 'chlorinate' 
chok: vc;VI VNPPP VPP component count nt vt 'choke' 
chondrifi: vc;chgAttr 'chondrify' 
chondrifie: vc;chgAttr 'chondrify' 
choos: vc;VNPNP VNPPP VNPPPas VNPTOoc VWHSS useC vacVO vt vtoV 'choose' 
chopp: vc;VNPPP artifact count vt 'chop' 
chortl: vc;VPP abstract count 'chortle' 
christianis: vc; 'christianise' 
chuckl: vc;VPP count v 'chuckle' 
chugg: vc;abstract count vt 'chug' 
cicatris: vc; 'cicatrise' 
cinche: vc;count prod0 v 'cinch' 
circl: vc;abstract component count vt 'circle' 
circularis: vc;vt 'circularise' 
circulat: vc;VNPPP VPP VPPPP VTH express move 'circulate' 
circumcis: vc;resume vt 'circumcise' 
circumscrib: vc;chgProperty vt 'circumscribe' 
circumvallat: vc;coil 'circumvallate' 
circumvolut: vc;enMove 'circumvolute' 
cit: vc;VHOWSS VNPPNGoc VNPPP VNPPPas abstract express praise vt 'cite' 
citie: nc;component count locUnit 'city' 
citifi: vc;chgAttr 'citify' 
citifie: vc;chgAttr 'citify' 
civilis: vc;mkOthersKnowledge vt 'civilise' 
civiliz: vc;mkOthersKnowledge vt 'civilize' 
clapp: vc;VNPPP VPP abstract count natural 'clap' 
clarifi: vc;express 'clarify' 
clarifie: vc;express 'clarify' 
clashe: vc;VI VIrecip VPP VerbNom count v 'clash' 
classicis: vc; 'classicise' 
classifi: vc;VNPPP VNPPPas VNPasAP chgInclude vt 'classify' 
classifie: vc;VNPPP VNPPPas VNPasAP chgInclude vt 'classify' 
cleav: vc;VNPPP VPP chgForm vt 'cleave' 
clenche: vc;VNPPP abstract enMove vt 'clench' 
climaxe: vc;VI VNPPP VPP VerbNom count situation 'climax' 
clinche: vc;VIrecip VPP abstract count vt 'clinch' 
clipp: vc;VNPPP component count prod vt 'clip' 
clogg: vc;VNPPP VerbNom count vt worsen 'clog' 
clopp: vc;express 'clop' 
clott: vc;VPP count 'clot' 
clutche: A;VNPPP VPP component count good tool vt 'clutch' 
co-operat: vc;VPP act hyphenated 'co-operate' 
co-ordinat: vc;abstract hyphenated 'co-ordinate' 
coagulat: vc;VNPPP VPP looksChg 'coagulate' 
coalesc: vc;VPP tie 'coalesce' 
coaxe: vc;VNPPP VNPTOoc vtPer 'coax' 
cobbl: vc;natural vt 'cobble' 
cobwebb: vc;artifact count 'cobweb' 
cocainis: vc;mkAct 'cocainise' 
cocainiz: vc;mkAct 'cocainize' 
coddl: vc;fondOf vt 'coddle' 
codifi: vc;produce vt 'codify' 
codifie: vc;produce vt 'codify' 
coerc: vc;VNPPP VNPTOoc enDo vt 'coerce' 
coggl: vc;move 'coggle' 
cogitat: vc;VPP VPPhowTO VWHSS mkOwnKnowledge vt 'cogitate' 
cogniz: vc;haveKnowledge vt 'cognize' 
coher: vc;VI VPP looksChg 'cohere' 
coincid: vc;VI VIrecip VPP from suit 'coincide' 
cok: vc;artifact vt 'coke' 
collaborat: vc;VPP VPPPP associate 'collaborate' 
collaps: vc;VI VPP VerbNom attack count nt sequence statePhy vt 'collapse' 
collat: vc;tryToKnow vt 'collate' 
collectiviz: vc;chgAttr 'collectivize' 
colli: vc;chgLooks 'colly' 
collid: vc;VI VIrecip VPP chgForm suit 'collide' 
collimat: vc;tryToKnow vt 'collimate' 
collocat: vc;VPP control tie 'collocate' 
collud: vc;VI VPP associate 'collude' 
colonie: nc;count 'colony' 
colonis: vc;create vt 'colonise' 
coloniz: vc;VNPPP create vt 'colonize' 
coloris: vc; 'colorise' 
colouris: vc; 'colourise' 
combatt: vc;VPP VerbNom prod0 vt 'combat' 
combin: vc;VI VIrecip VNPPP VPP abstract artifact count group vt 'combine' 
commemorat: vc;VNPPP pEmo vt 'commemorate' 
commenc: vc;VI VPP act vtoV 'commence' 
commentat: vc;VPP 'commentate' 
commercialis: vc;chgAttr vt 'commercialise' 
commercializ: vc;chgAttr vt 'commercialize' 
commingl: vc;VIrecip VPP tie 'commingle' 
comminut: vc;chgForm 'comminute' 
commiserat: vc;VPP nAttitude vt 'commiserate' 
committ: vc;VNPPNGoc VNPPP VNPTOoc VPNGsc VPP vt vtoV 'commit' 
commixe: vc;tie 'commix' 
commun: ;VI VIrecip VPP count org v 'commune' 
communicat: vc;VI VIrecip VNPPP VPP VPPPP VPPTH VPPhowTO VPhisNG express vt 'communicate' 
communis: vc;vt 'communise' 
commut: vc;VNPPP VPP VPPPP VerbNom 'commute' 
commutat: vc;chgPoss 'commutate' 
companie: nc;comHN component count intimacy 'company' 
compar: vc;VNPPP VNPPhisNG VPP VRB vt 'compare' 
compartmentalis: vc;vt 'compartmentalise' 
compasse: vc;count prod tool vt 'compass' 
compell: vc;VNPTOoc enDo vt 'compel' 
compensat: vc;VNPPP VNPRB VPP give vt 'compensate' 
comper: vc;count job vi 'compere' 
compet: vc;VI VIrecip VPP VPPPP VPPas pt 'compete' 
compil: vc;VNPPP VNPPPas produce vt 'compile' 
complet: A;APP VNG degree range situation vt 'complete' 
complexifi: vc;worsen 'complexify' 
complexifie: vc;worsen 'complexify' 
compli: vc;VPP chgFit vi 'comply' 
complicat: vc;mkAct vt worsen 'complicate' 
complie: vc;VPP chgFit vi 'comply' 
complott: vc;mkOwnKnowledge 'complot' 
compos: vc;VNPPP VNPPPas VPP produce vt 'compose' 
compresse: vc;VNPPP count lessC tool vt 'compress' 
compris: vc;VNPPP containV inclusive tWord vt 'comprise' 
compromis: A vc;VPP VerbNom tWord 'compromise' 
comput: vc;VNPPP tryToKnow vt 'compute' 
computeriz: vc;chgAttr vt 'computerize' 
concatenat: vc;tie vt 'concatenate' 
conced: vc;VNG VNPTObe VPP VSS VTH chgFit dative express give 'concede' 
conceiv: vc;CR VI VNPPPas VPP VTH beNormal deduce vt 'conceive' 
concentrat: vc;VNPPNGsc VNPPP VNPPPPP VPP VPhisNG count phy 'concentrate' 
conciliat: vc;VNPPP associate chgEmo persuade 'conciliate' 
conclud: vc;VI VNPPP VPNGsc VPP VSS VTH decide mkBetter vt 'conclude' 
concretis: vc;chgAttr 'concretise' 
concretiz: vc;chgAttr 'concretize' 
concurr: vc;VI VPP sequence vi 'concur' 
concusse: vc;move 'concuss' 
condens: vc;VNPPP chgMeasure looksChg mkBetter 'condense' 
condol: vc;emo vt 'condole' 
condon: vc;nAttitude nt vt 'condone' 
confabb: vc;VIrecip VPP abstract count v 'confab' 
confabulat: vc;VI VIrecip VPP communicate 'confabulate' 
confederat: A vc;VIrecip VPP count per vt 'confederate' 
conferr: vc;VIrecip VNPPP VPP VPPPP communicate give 'confer' 
confesse: vc;VPNGsc VPP VPPTH VSS VTH express 'confess' 
confid: vc;VNPPP VPPTH VTH 'confide' 
configur: vc;VNPTOoc create vt 'configure' 
confin: vc;VNPPNGoc VNPPP causeNotDo chgProperty tWord vt 'confine' 
confiscat: vc;collect vt 'confiscate' 
conflagrat: vc;warmUp 'conflagrate' 
conflat: vc;VNPPP VPP tie 'conflate' 
confus: vc;VNPPP annoy passion vt weakPI 'confuse' 
confut: vc;reply vt 'confute' 
cong: vc;count v 'conge' 
congratulat: vc;VNPPP congr pEmo pt vt 'congratulate' 
congregat: vc;VI VIrecip VPP enMove 'congregate' 
conjectur: vc;VTH abstract 'conjecture' 
conniv: vc;VPP VPPPP associate mkOwnKnowledge 'connive' 
connot: vc;mkOthersKnowledge vt 'connote' 
consecrat: vc;VNPNP VPP give pEmo vt 'consecrate' 
conserv: vc;keep move vt 'conserve' 
consociat: vc;associate 'consociate' 
consol: vc;component count tool vt 'console' 
consolidat: vc;VNPPP VPP chgProperty mkBetter 'consolidate' 
conspir: vc;VI VIrecip VPP mkOwnKnowledge vtoV 'conspire' 
conspiracie: nc;VerbNom thinking 'conspiracy' 
consternat: vc;annoy 'consternate' 
constipat: vc;metabolize vt 'constipate' 
constitut: vc;create inclusive vt 'constitute' 
constitutionalis: vc; 'constitutionalise' 
constru: vc;VNPPPas VNPTOoc express vt 'construe' 
consum: vc;chgQuant use vacVO vt 'consume' 
consummat: A;VNPPP plusAmount quality up vt 'consummate' 
contaminat: vc;VNPPP vt worsen 'contaminate' 
contemplat: vc;VPP VTH VhisNG act tryToKnow vVing vt 'contemplate' 
contemporis: vc;appear 'contemporise' 
contemporiz: vc;appear 'contemporize' 
continu: vc;VI VNG VPNGsc VPP VPPas VRB beNormal enGrow vtoV 'continue' 
contradistinguishe: vc;VPP tryToKnow vt 'contradistinguish' 
contraindicat: vc;causeNotDo vt 'contraindicate' 
contraven: vc;chgFit lessC vt 'contravene' 
contribut: vc;VI VNPPP VPP give vt 'contribute' 
contriv: vc;mkOwnKnowledge vt 'contrive' 
contus: vc;troubleW vt 'contuse' 
convalesc: vc;VI cease keep statePhy vi 'convalesce' 
conven: vc;control move perOrgV 'convene' 
conventionalis: vc;chgAttr vt 'conventionalise' 
conventionaliz: vc;chgAttr vt 'conventionalize' 
converg: vc;VI VIrecip VPP move tie 'converge' 
convers: vc;VI VIrecip VPP VPPPP abstract count 'converse' 
convinc: vc;VNPPP VNPSS VNPTOoc haveKnowledge perOrgV vtPer 'convince' 
convok: vc;vt 'convoke' 
convolut: A;nt vt 'convolute' 
convuls: vc;move perV suffer 'convulse' 
cooperat: vc;VI VIrecip VPP VPPPP VPhisNG act 'cooperate' 
coordinat: A nc vc;VNPPP abstract count 'coordinate' 
copi: vc;Nom VNPPP VPP abstract artifact vt 'copy' 
copie: vc;Nom VNPPP VPP abstract artifact vt 'copy' 
copolymeris: vc; 'copolymerise' 
copp: vc;count currency job useC vt 'cop' 
copulat: vc;VI VIrecip VPP associate 'copulate' 
cornic: vc;component count v 'cornice' 
coronat: vc;give vt 'coronate' 
corrall: vc;count vt 'corral' 
correlat: vc;VNPPP abstract 'correlate' 
corroborat: vc;VTH mkOwnKnowledge tWord vt 'corroborate' 
corrod: vc;looksChg mkBad 'corrode' 
coruscat: vc;chgLooks vt 'coruscate' 
coshe: vc;count tool v 'cosh' 
cossett: vc;fondOf vt 'cosset' 
countenanc: vc;VNPNGoc abstract looks vt 'countenance' 
counter-bidd: vc;communicate hyphenated 'counter-bid' 
counterbalanc: vc;VIrecip VPP VerbNom content count strength vt 'counterbalance' 
counterchalleng: vc; 'counterchallenge' 
counterchang: vc;chgPoss 'counterchange' 
countercharg: vc;abstract v 'countercharge' 
countermin: vc;botchW count vt 'countermine' 
counterplott: vc;VPP abstract count vt 'counterplot' 
countrie: nc; 'country' 
cours: vc;Nom VPPdir artifact count vacOf vt vtoV 'course' 
coxe: vc;count vt 'cox' 
cradl: vc;VNPPP count tool vt 'cradle' 
cramm: A vc;VNPPP VPP a moveIn 'cram' 
cranberrie: nc;plant 'cranberry' 
crash-div: vc;VNPPP VPP count hyphenated 'crash-dive' 
crashe: A;VI VNPPP VPP VerbNom troubleW vt 'crash' 
crav: vc;VPP emph love passion perV vt 'crave' 
crawfishe: vc;animal v 'crawfish' 
creas: vc;count natural vt 'crease' 
creat: vc;VNPNP VNPPNGoc VNPTOoc causeV perOrgV tWord vacVO vt 'create' 
cremat: vc;vt warmUp 'cremate' 
creosot: vc;artifact v 'creosote' 
crep: vc;artifact 'crepe' 
cri: vc;VPP VSS VTH VerbNom count mental natural needForW perV vi vt 'cry' 
crie: vc;VPP VSS VTH VerbNom count mental natural needForW perV vi vt 'cry' 
criminalis: vc; 'criminalise' 
criminat: vc;VNPPNGoc VNPPP blame mkOwnKnowledge 'criminate' 
cring: vc;VI move vi 'cringe' 
crinkl: vc;count natural 'crinkle' 
crippl: A;aggravateW vt 'cripple' 
crisscrosse: vc;VNPPP VPP component vt 'crisscross' 
criticis: vc;VNPPP VNPPhisNG blame perOrgV vt 'criticise' 
criticiz: vc;VI VNPPNGoc VNPPP VNPPPas VNPPhisNG VNPasAP VWHSS blame passion perOrgV vt weakPI 'criticize' 
critiqu: vc;count v 'critique' 
cropp: vc;VNPAP VNPPP count looks plant vt 'crop' 
cross-examin: vc;ask hyphenated vt 'cross-examine' 
cross-indexe: vc;VNPPP count hyphenated 'cross-index' 
cross-pollinat: vc;hyphenated send vt 'cross-pollinate' 
crosscutt: A vc;a count v 'crosscut' 
crouche: vc;VI VPP count statePhy v 'crouch' 
crucifi: vc;mkBad vt 'crucify' 
crucifie: vc;mkBad vt 'crucify' 
crumbl: vc;VI VNPPP VPP looksChg nt sequence vt 'crumble' 
crumpl: vc;chgForm looksChg 'crumple' 
crunche: vc;abstract count vt 'crunch' 
crushe: vc;VNPPP VPP abstract count vt 'crush' 
crystalis: vc;vt 'crystalise' 
crystallis: vc; 'crystallise' 
crystalliz: vc;chgLooks chgProperty 'crystallize' 
cuddl: vc;VIrecip VPP abstract count vt 'cuddle' 
culminat: vc;VPP 'culminate' 
cultivat: vc;enGrow mkBetter promoteW 'cultivate' 
cumulat: vc;chg vt 'cumulate' 
cupp: vc;VNPPP count currency prod vt 'cup' 
curat: vc;count job v 'curate' 
curdl: vc;VPP chgLooks looksChg 'curdle' 
curett: vc;tool v 'curette' 
currencie: nc;abstract artifact 'currency' 
curri: vc;artifact vt 'curry' 
curs: vc;VI VNPNGoc VPP VerbNom count hate nt vt 'curse' 
curtsi: vc;VI VPP count vi 'curtsy' 
curtsie: vc;VI VPP count vi 'curtsy' 
curv: vc;VPP VPPdir abstract count natural posture 'curve' 
curvett: vc;abstract v 'curvet' 
cusse: vc;count per v 'cuss' 
customis: vc;VNPPP VNPPPas create vt 'customise' 
customiz: vc;VNPPP VNPPPas create vt 'customize' 
cutt: vc;VBDN VNPPP VPP VerbNom count lessC space vt 'cut' 
cycl: vc;VPPdir count quant timeUnit 'cycle' 
cyclostyl: vc;count tool vt 'cyclostyle' 
dabb: vc;VI VPP abstract count v 'dab' 
dabbl: vc;VNPPP VPP chgMeasure 'dabble' 
daddie: nc;count per 'daddy' 
daguerreotyp: vc;count v 'daguerreotype' 
dalli: vc;VI VPNGsc VPP doNot vi whileAway 'dally' 
dallie: vc;VI VPNGsc VPP doNot vi whileAway 'dally' 
damag: vc;VerbNom aggravateW attack nt vt 'damage' 
damnifi: vc;mkBad 'damnify' 
damnifie: vc;mkBad 'damnify' 
danc: vc;VPP VerbNom vt 'dance' 
dandifi: vc;beautify 'dandify' 
dandifie: vc;beautify 'dandify' 
dandl: vc;pt vt 'dandle' 
dangl: vc;VNPPP VPP move nt 'dangle' 
dapp: vc;move 'dap' 
dappl: vc;VNPPP animal vt 'dapple' 
dar: nc vc;MD VI VNPTOoc abstract count vt vtoV 'dare' 
dashe: vc;VNPPP count 'dash' 
dawdl: vc;VI VPP doNot move spend vi 'dawdle' 
daz: vc;VPP abstract count vt 'daze' 
dazzl: vc;VNPPP VPP abstract chgLooks 'dazzle' 
de-escalat: vc;VPP chgProperty hyphenated 'de-escalate' 
de-ic: vc;hyphenated looksChg vt 'de-ice' 
deactivat: vc;enHidden 'deactivate' 
deaerat: vc;enHidden 'deaerate' 
debarr: vc;VNPPP VNPPhisNG causeNotDo collect vt 'debar' 
debas: vc;VNPPP chgProperty chgQuant vt 'debase' 
debat: vc;VIrecip VNPPP VPP VWHSS VerbNom VhisNG 'debate' 
debauche: vc;VNPPP count vt 'debauch' 
debilitat: vc;attack situation vt 'debilitate' 
debon: vc;enHidden 'debone' 
debugb: vc;mkBetter resume vt 'debug' 
decalcifi: vc;enHidden 'decalcify' 
decalcifie: vc;enHidden 'decalcify' 
decapitat: vc;mkBad vt 'decapitate' 
deceas: vc;VI VerbNom statePhy vi 'decease' 
deceiv: vc;VI VNPPP VPhisNG mkMisunderstand vt 'deceive' 
decelerat: vc;chgMeasure lessC 'decelerate' 
decentralis: vc;chgAttr nAttitude vt 'decentralise' 
decentraliz: vc;chgAttr nAttitude vt 'decentralize' 
decid: vc;VHOWSS VI VPP VSS VTH VWHSS decide vt vtoV 'decide' 
decimalis: vc;chg vt 'decimalise' 
decimaliz: vc;chg vt 'decimalize' 
decimat: vc;attack remove vt 'decimate' 
declar: vc;VNPAP VNPNP VNPPPas VNPTObe VPP VSS VTH express perOrgV tWord vt 'declare' 
declassifi: vc;VNPPP mkAct vt 'declassify' 
declassifie: vc;VNPPP mkAct vt 'declassify' 
declin: vc;VI VNG VerbNom count nt prospect statePhy vt vtoV 'decline' 
decod: vc;VNPPP VPP VPPPP express vt 'decode' 
decoloris: vc; 'decolorise' 
decolouris: vc; 'decolourise' 
decolouriz: vc;chgLooks 'decolourize' 
decompos: vc;VNPPP chgConnect mkBad 'decompose' 
decompresse: vc;chgProperty 'decompress' 
deconcentrat: vc;nAttitude 'deconcentrate' 
decorat: vc;VNPPP beautify control 'decorate' 
decorticat: vc;enAppear vt 'decorticate' 
decoupl: vc;chg 'decouple' 
decreas: vc;VI VNPPP VPP VPPPP VerbNom count lessC statePhy vt 'decrease' 
decri: vc;VNPPNGoc VNPPP annoy blame vt 'decry' 
decrie: vc;VNPPNGoc VNPPP annoy blame vt 'decry' 
decriminalis: vc;chgAttr 'decriminalise' 
decriminaliz: vc;chgAttr 'decriminalize' 
dedicat: vc;VNPPP VNPPPas VNPPhisNG pt vt 'dedicate' 
deduc: vc;VNPPP VNPPhisNG VPPTH VTH think vt 'deduce' 
deep-freez: vc;count hyphenated vt 'deep-freeze' 
deep-fri: vc;hyphenated produce 'deep-fry' 
deep-frie: vc;hyphenated produce 'deep-fry' 
deepfreez: vc;enMove 'deepfreeze' 
defac: vc;mkBad vt 'deface' 
defalcat: vc;take vt 'defalcate' 
defam: vc;VNPPhisNG annoy playDown vtPer 'defame' 
defatt: vc;enHidden 'defat' 
defecat: vc;VNPAP express metabolize 'defecate' 
defeminis: vc;enHidden 'defeminise' 
defeminiz: vc;enHidden 'defeminize' 
deferr: vc;VNG VNPPP VPP chgMeasure vVing 'defer' 
defi: vc;VNPTOoc chgFit doNot nAttitude vt 'defy' 
defie: vc;VNPTOoc chgFit doNot nAttitude vt 'defy' 
defil: vc;VNPPP artifact component count natural vt 'defile' 
defin: vc;VNPPP VNPPPas VNPTObe VNPTOoc VNPasAP VWHSS express mkOwnKnowledge vt 'define' 
deflat: vc;lessC move 'deflate' 
defogg: vc; 'defog' 
defoliat: vc;enAppear 'defoliate' 
defus: vc;chgProperty correctW vt 'defuse' 
degase: vc;enHidden 'degas' 
degausse: vc;chgProperty vt 'degauss' 
degenerat: A;VI VPP VPPPP a count lessC nt per vt 'degenerate' 
degrad: vc;VNPPP VPP attack chgGrade 'degrade' 
degreas: vc;enHidden 'degrease' 
dehumanis: vc;annoy vt 'dehumanise' 
dehumaniz: vc;annoy 'dehumanize' 
dehumidifi: vc;enHidden 'dehumidify' 
dehumidifie: vc;enHidden 'dehumidify' 
dehydrat: vc;VI VPP enHidden ownNot 'dehydrate' 
dehydrogenat: vc;enHidden 'dehydrogenate' 
deifi: vc;chgAttr vt 'deify' 
deifie: vc;chgAttr vt 'deify' 
delegat: vc;VNPPP VNPTOoc VerbNom count per 'delegate' 
delet: vc;VI enHidden remove 'delete' 
delimitat: vc;chgProperty 'delimitate' 
delineat: vc;VNPPP VPPhowTO VWHSS chgProperty express vt 'delineate' 
delud: vc;VNPPNGoc VNPPP VTH mkMisunderstand vt 'delude' 
delv: vc;VI VPP VRB vi 'delve' 
demagnetis: vc;chgProperty vt 'demagnetise' 
demagnetiz: vc;chgProperty 'demagnetize' 
demarcat: vc;VNPPP VNPPPas VNPRB chgProperty vt 'demarcate' 
demasculinis: vc;enHidden 'demasculinise' 
demasculiniz: vc;enHidden 'demasculinize' 
demilitariz: vc;VI enHidden 'demilitarize' 
demitt: vc;give 'demit' 
demobb: vc;chgInclude vt 'demob' 
demobilis: vc;chgInclude vt 'demobilise' 
demobiliz: vc;chgInclude vt 'demobilize' 
democratis: vc;chgAttr vt 'democratise' 
democratiz: vc;chgAttr vt 'democratize' 
demodulat: vc;tryToKnow vt 'demodulate' 
demolishe: vc;looksChg mkBad remove vt 'demolish' 
demonetis: vc;vt 'demonetise' 
demonis: vc;chgAttr vt 'demonise' 
demoniz: vc;chgAttr vt 'demonize' 
demonstrat: vc;VHOWSS VI VNPPP VNPPPas VNPTObe VPP VSS VTH fight show tWord vt 'demonstrate' 
demoralis: vc;annoy vtPer 'demoralise' 
demoraliz: vc;annoy vtPer 'demoralize' 
demot: vc;VNPPP VNPPhisNG chgGrade vt 'demote' 
demulsifi: vc;enHidden 'demulsify' 
demulsifie: vc;enHidden 'demulsify' 
demystifi: vc;chgAttr 'demystify' 
demystifie: vc;chgAttr 'demystify' 
demythologis: vc;vt 'demythologise' 
denationalis: vc;chgAttr vt 'denationalise' 
denationaliz: vc;chgAttr vt 'denationalize' 
denaturalis: vc; 'denaturalise' 
denazifi: vc;enHidden 'denazify' 
denazifie: vc;enHidden 'denazify' 
deni: vc;VNG VNPPPas VNPPPfor VTH VhisNG attack dative vVing vt 'deny' 
denie: vc;VNG VNPPPas VNPPPfor VTH VhisNG attack dative vVing vt 'deny' 
denigrat: vc;attack playDown thing vt 'denigrate' 
denitrifi: vc;enHidden 'denitrify' 
denitrifie: vc;enHidden 'denitrify' 
denominat: vc;enBe 'denominate' 
denot: vc;beC vt 'denote' 
denounc: vc;VNPPNGoc VNPPP VNPPPas blame perOrgV vt 'denounce' 
denucleariz: vc;mkAct 'denuclearize' 
denud: vc;VNPPP collect enAppear 'denude' 
denunciat: vc; 'denunciate' 
deodoris: vc; 'deodorise' 
deodouris: vc; 'deodourise' 
deoxidiz: vc;enHidden 'deoxidize' 
depersonalis: vc;enHidden 'depersonalise' 
depersonaliz: vc;enHidden 'depersonalize' 
depictur: vc;express 'depicture' 
depilat: vc;enHidden 'depilate' 
deplan: vc;VI move 'deplane' 
deplet: vc;VNPPP chgQuant 'deplete' 
deplor: vc;VTH VhisNG mkOthersKnowledge nAttitude nt vt 'deplore' 
deplum: vc;collect 'deplume' 
depolaris: vc;vt 'depolarise' 
depos: vc;VI VNPPNGoc VNPPP causeNotBe enHidden 'depose' 
deprav: vc;annoy beC vt 'deprave' 
deprecat: vc;disagree vt 'deprecate' 
depreciat: vc;VPP VPPPP attack lessC 'depreciate' 
depresse: vc;VNPNP lessC passion vt 'depress' 
depressuris: vc; 'depressurise' 
depriv: vc;VNPPP collect vt 'deprive' 
deput: vc;VNPPP VNPPPas VNPTOoc enDo vt 'depute' 
deputiz: vc;VNPPNGoc VNPPP VNPPPas VPP beC 'deputize' 
deracinat: vc;moveOut vt 'deracinate' 
derang: vc;injureW mkBad vt 'derange' 
derat: vc;chgQuant vt 'derate' 
derid: vc;VNPPNGoc VNPPP VNPPPas annoy vt 'deride' 
deriv: vc;VNPPNGsc VNPPP VPP beNormal causeV chgPoss vt 'derive' 
desalinat: vc;VI chgAttr enHidden 'desalinate' 
desaliniz: vc;chgAttr enHidden 'desalinize' 
descal: vc;enHidden 'descale' 
descri: vc;VNPNGoc haveKnowledge vt 'descry' 
describ: vc;VNPPP VNPPPas VNPasAP VPPhowTO express infoV vt 'describe' 
descrie: vc;VNPNGoc haveKnowledge vt 'descry' 
desecrat: vc;VNPPP vt 'desecrate' 
desensitis: vc;VI VNPPP VPP enHidden 'desensitise' 
desensitiz: vc;VI VNPPP VPP enHidden 'desensitize' 
deserv: vc;property pt vt vtoV 'deserve' 
desexualis: vc; 'desexualise' 
designat: A vc;VNPAP VNPNP VNPPNGoc VNPPP VNPPPas VNPTOoc VNPasAP VNPasEN chgProperty enBe use 'designate' 
desir: vc;VNG VNPEN VNPPP VNPTOoc VPPforTO VTH VerbNom mental need needForW passion perV purpose stateMental useC vt vtoV weakPI 'desire' 
despatche: vc;VNPPPas VNPPPdir abstract count vt 'despatch' 
despis: vc;VPPforTO VhisNG emph hate passion vt vtoV 'despise' 
desquamat: vc;enAppear vt 'desquamate' 
destabilis: vc;vt 'destabilise' 
destalinis: vc;vt 'destalinise' 
destin: vc;VNPPP VNPPhisNG VNPTOoc express 'destine' 
destinie: nc;VerbNom situation 'destiny' 
desynchronis: vc;vt 'desynchronise' 
detache: vc;VNPPP enDo vt 'detach' 
deteriorat: vc;VI beBad lessC nt sequence vt 'deteriorate' 
determin: vc;CR VHOWSS VNPPPas VNPTObe VSS VTH VWHSS decide tryToKnow vt vtoV 'determine' 
deterr: vc;VNPPhisNG attack causeNotDo vt 'deter' 
dethron: vc;causeNotBe enHidden 'dethrone' 
detonat: vc;vt warmUp 'detonate' 
detoxe: vc;treatment 'detox' 
detoxicat: vc;enHidden 'detoxicate' 
detoxifi: vc;VI VNPPP VPP enHidden 'detoxify' 
detoxifie: vc;VI VNPPP VPP enHidden 'detoxify' 
detransitivis: vc; 'detransitivise' 
detribalis: vc;vt 'detribalise' 
deuterat: vc;chgAttr 'deuterate' 
devalu: vc;quantChg vt 'devalue' 
devaluat: vc;VPP VPPPP quantChg 'devaluate' 
devastat: vc;VNPPP attack mkBad remove vt 'devastate' 
deviat: vc;VPP per 'deviate' 
devilis: vc; 'devilise' 
devis: vc;VNPPP VNPPPas VNPTOoc abstract enExist mkOwnKnowledge pt vt 'devise' 
devitalis: vc;attack chgProperty vt 'devitalise' 
devitaliz: vc;attack chgProperty vt 'devitalize' 
devitrifi: vc;enHidden 'devitrify' 
devitrifie: vc;enHidden 'devitrify' 
devolv: vc;VPP beBad give 'devolve' 
devot: vc;VNPPP VNPPhisNG give tWord vt 'devote' 
diabolis: vc; 'diabolise' 
diagnos: vc;VNPPNGoc VNPPPas check tWord vt 'diagnose' 
diagonalis: vc;vt 'diagonalise' 
dialys: vc; 'dialyse' 
dialyz: vc; 'dialyze' 
dibb: vc;ceaseMove 'dib' 
dibbl: vc;count tool 'dibble' 
dictat: vc;VNPPP VTH VWHSS abstract chg count vt 'dictate' 
differentiat: vc;VNPPP tryToKnow vt 'differentiate' 
difficultie: nc;bad count problem 'difficulty' 
diffus: A;VNPPP VPP chg 'diffuse' 
digg: vc;VPP VerbNom count 'dig' 
digitaliz: vc;chgAttr vt 'digitalize' 
digitis: vc;chgAttr vt 'digitise' 
digitiz: vc;chgAttr vt 'digitize' 
dignifi: vc;VNPPP VNPPhisNG reputation vt 'dignify' 
dignifie: vc;VNPPP VNPPhisNG reputation vt 'dignify' 
digresse: vc;VI VPP chgFit content vi 'digress' 
dilat: vc;VPP chgMeasure express move 'dilate' 
dilly-dalli: vc;VI VPP chgMeasure hyphenated vi 'dilly-dally' 
dilly-dallie: vc;VI VPP chgMeasure hyphenated vi 'dilly-dally' 
dillydalli: vc;chgMeasure nt 'dillydally' 
dillydallie: vc;chgMeasure nt 'dillydally' 
dilut: A;VNPPP concentration lessC minusAmount vt 'dilute' 
diminishe: vc;VI VPP VRB chgMeasure chgQuant lessC quantChg vt 'diminish' 
dimm: A;bright clear content vt 'dim' 
dimpl: vc;component count vt 'dimple' 
dipp: vc;VNPPP VerbNom vt 'dip' 
disabl: vc;nt remove vt 'disable' 
disabus: vc;VNPPP resume vt 'disabuse' 
disaffiliat: vc;chgConnect 'disaffiliate' 
disagre: vc;VI VPP VPPPP VPPTH VPhisNG VTH intimacy nAttitude suit vi 'disagree' 
disambiguat: vc;enHidden 'disambiguate' 
disapprov: vc;VI VPP VPPNG VPhisNG disagree 'disapprove' 
disarrang: vc;mkBad vt 'disarrange' 
disassembl: vc;chgConnect move 'disassemble' 
disbarr: vc;enHidden 'disbar' 
disbeliev: vc;nAttitude nt 'disbelieve' 
disbudd: vc;end vt 'disbud' 
disburs: vc;VNPPPdir give 'disburse' 
discharg: vc;VNPPP VerbNom vt 'discharge' 
disciplin: vc;VNPPPas component vt 'discipline' 
disclos: vc;VNPPP VPPTH VSS VTH VWHSS enAppear vt 'disclose' 
discoloris: vc; 'discolorise' 
discombobulat: vc;VNPPP attack chgKnow vt 'discombobulate' 
discommod: vc;chg vt 'discommode' 
discompos: vc;annoy vt 'discompose' 
discontinu: vc;VNG VNPPP VNPPPas remove vt 'discontinue' 
discountenanc: vc;causeNotDo vt 'discountenance' 
discourag: vc;VNPPNGoc VNPPP VNPPhisNG attack vt 'discourage' 
discours: vc;VI VIrecip VPP VPhisNG VerbNom info v 'discourse' 
discriminat: A vc;VI VPP troubleW 'discriminate' 
discusse: vc;VHOWSS VNPPP VWHSS VhisNG infoV vt 'discuss' 
disembodi: vc;separate vt 'disembody' 
disembodie: vc;separate vt 'disembody' 
disenabl: vc;enHidden 'disenable' 
disengag: vc;VNPPP separate 'disengage' 
disentangl: vc;VNPPP VPP separate 'disentangle' 
disestablishe: vc;enHidden 'disestablish' 
disfigur: vc;looksChg mkBad vt 'disfigure' 
disfranchis: vc;collect vt 'disfranchise' 
disgorg: vc;VPP give moveOut 'disgorge' 
disgruntl: vc;nEmo vt 'disgruntle' 
disguis: vc;VNPPPas abstract act count phy vt 'disguise' 
dishevell: vc;aggravateW mkAct 'dishevel' 
dishwashe: vc; 'dishwash' 
disinclin: vc;volition vt 'disincline' 
disintegrat: vc;chgConnect sequence statePhy suffer 'disintegrate' 
dislik: vc;VNPPP VTH VerbNom VhisNG count hate passion perV stateMental vVing vt weakPI 'dislike' 
dislocat: vc;ill mkBad vt 'dislocate' 
dislodg: vc;VNPPP enHidden expel 'dislodge' 
dismantl: vc;chgConnect enHidden lessC move 'dismantle' 
dismisse: vc;VNPPP VNPPPas chgInclude disagree enHidden remove 'dismiss' 
disoblig: vc;annoy vt 'disoblige' 
disorganiz: vc;attack mkBad vt 'disorganize' 
disorientat: vc;annoy noKnowledge vt 'disorientate' 
disparag: A vc;VNPPNGoc VNPPP VhisNG annoy chgProperty nAttitude vtPer 'disparage' 
dispatche: vc;VNPPP VerbNom chg count vt 'dispatch' 
dispens: vc;VPP VPhisNG give 'dispense' 
dispers: vc;VNPPP move send 'disperse' 
displac: vc;chgIsa chgLoc vt 'displace' 
displeas: vc;annoy passion vtPer weakPI 'displease' 
dispos: vc;VNPPP VNPTOoc VPP control give 'dispose' 
dispossesse: vc;VNPPP collect vt 'dispossess' 
disprov: vc;VTH attack vt 'disprove' 
disput: vc;VI VIrecip VPP VPPPP VTH VWHSS VerbNom attack count lessC vt 'dispute' 
disqualifi: vc;VNPPP VNPPhisNG VNPTOoc chgFit enHidden 'disqualify' 
disqualifie: vc;VNPPP VNPPhisNG VNPTOoc chgFit enHidden 'disqualify' 
disreput: nc vc;abstract troubleW 'disrepute' 
dissatisfi: vc;annoy passion vtPer weakPI 'dissatisfy' 
dissatisfie: vc;annoy passion vtPer weakPI 'dissatisfy' 
disse: vc;blame 'diss' 
dissembl: vc;VNPPP act mkNoKnowledge vt 'dissemble' 
disseminat: vc;VNPPP express vt 'disseminate' 
disserv: vc;mkBad 'disserve' 
dissimulat: vc;VNPPP mkNoKnowledge 'dissimulate' 
dissipat: vc;VI chgQuant send statePhy 'dissipate' 
dissociat: vc;VNPPP chgConnect connective 'dissociate' 
dissolv: vc;VI VNPPP VPP VPPPP abstract lessC vt 'dissolve' 
dissuad: vc;VNPPP causeNotDo vt 'dissuade' 
distinguishe: vc;VNPPP VNPPPas VPP tWord tryToKnow vt 'distinguish' 
distresse: vc;VerbNom attack feeling vt 'distress' 
distribut: vc;VI VNPPP VNPPPas VNPRB VPP control give move tWord vt 'distribute' 
disunit: vc;VIrecip chgConnect vt 'disunite' 
ditche: vc;artifact count remove 'ditch' 
div: vc;VI VPP VPPdir VerbNom count lessC 'dive' 
divaricat: vc;chgConnect looksChg 'divaricate' 
diverg: vc;VIrecip VPP chgFit move separate 'diverge' 
diversifi: vc;VPP chgAttr kind 'diversify' 
diversifie: vc;VPP chgAttr kind 'diversify' 
divid: vc;VI VIrecip VNPPP VPP VerbNom count vt 'divide' 
divin: A;VI abstract count per pt vt 'divine' 
divorc: vc;VIrecip VNPPP VerbNom perOrgV remove separate vtPer 'divorce' 
divulg: vc;VNPPP VPPTH enAppear vt 'divulge' 
divvi: vc;abstract count v 'divvy' 
divvie: vc;abstract count v 'divvy' 
dodg: vc;VNG abstract count doNot vt 'dodge' 
dogsledd: vc;tool v 'dogsled' 
dolli: vc;count 'dolly' 
dollie: vc;count 'dolly' 
domesticat: vc;mkOthersKnowledge vt 'domesticate' 
domesticis: vc;mkOthersKnowledge 'domesticise' 
domesticiz: vc;mkOthersKnowledge 'domesticize' 
dominat: vc;chg 'dominate' 
donat: vc;VNPPP pt vt 'donate' 
donn: vc;count vt 'don' 
doodl: vc;VI VPP 'doodle' 
dosse: vc;VI vi 'doss' 
dott: vc;VNPPP abstract count natural vt 'dot' 
doubl: A vc;RB VI VPP VPPas a abstract count vt 'double' 
douch: vc;count tool 'douche' 
dous: vc;VNPPP enHidden 'douse' 
dov: vc;animal component length past per tWord v 'dove' 
downgrad: vc;VNPPP VerbNom nt vt 'downgrade' 
downplai: vc;vt 'downplay' 
downplaie: vc;vt 'downplay' 
dows: vc;VI VPP abstract v 'dowse' 
doz: vc;VI cease count vi 'doze' 
dragg: vc;VI VNPPPdir VNPRB VPP count vt 'drag' 
drap: vc;VNPPP VPP VRB count prod tool 'drape' 
dredg: vc;VNPPP count tool vt 'dredge' 
drenche: vc;VNPPP moveIn vt 'drench' 
dresse: vc;Nom VI VNPPP VPP looks tool vt vtoV 'dress' 
dri: A vc;VI VNPPP chgMeasure con tWord vt 'dry' 
dribbl: vc;VNPPP VPP abstract component natural 'dribble' 
drie: A vc;VI VNPPP chgMeasure con tWord vt 'dry' 
dripp: vc;VI VPP abstract count v 'drip' 
driv: vc;Nom VI VNPAP VNPPNGoc VNPPPPP VNPPPdir VNPRB VNPTOoc VPP VPPPP VPPdir VRB component length tWord vt vtoV 'drive' 
drizzl: vc;VI natural v 'drizzle' 
dropp: vc;VI VNPPPdir VPP VPPPP VPPPPdir VPPdir VRB VerbNom VhisNG count dative negAdj phy statePhy vAP vt 'drop' 
drows: vc;VI count vi 'drowse' 
drubb: vc;mkBad vt 'drub' 
drudg: vc;count per 'drudge' 
drumm: vc;VI VNPPP artifact count vt 'drum' 
dubb: vc;VNPNP chg 'dub' 
dulcifi: vc;chgEmo 'dulcify' 
dulcifie: vc;chgEmo 'dulcify' 
dunn: vc;VNPPP VNPTOoc count vt 'dun' 
dup: vc;VNPPP count per vt 'dupe' 
duplicat: A vc;count vt 'duplicate' 
dwindl: vc;VI VPP VPPPP chgMeasure lessC 'dwindle' 
dyk: vc;artifact count vt 'dyke' 
dynamis: vc; 'dynamise' 
dynamit: vc;artifact vt 'dynamite' 
eas: vc;VI VNPPPPP VNPPPdir VPP correctW easiness pt vt 'ease' 
eavesdropp: vc;VI VPP sense vi 'eavesdrop' 
ebonis: vc; 'ebonise' 
eclips: vc;chg nt vt 'eclipse' 
economiz: vc;VPP chgQuant 'economize' 
eddi: vc;VI count natural v 'eddy' 
eddie: vc;VI count natural v 'eddy' 
edg: vc;VI VNPNP VNPPP VNPRB VPNGsc VPP VPPdir VRB component count prod0 tWord vt 'edge' 
edifi: vc;enGrow mkOthersKnowledge 'edify' 
edifie: vc;enGrow mkOthersKnowledge 'edify' 
editorialis: vc;produce 'editorialise' 
editorializ: vc;produce 'editorialize' 
educ: vc;CR VNPPP vt 'educe' 
educat: vc;VNPPP VNPPhisNG enGrow mkOthersKnowledge 'educate' 
effac: vc;enHidden 'efface' 
effectuat: vc;mkBetter vt 'effectuate' 
effloresc: vc;looksChg vt 'effloresce' 
effus: A vc;goOut vt 'effuse' 
ego-tripp: vc;hyphenated take 'ego-trip' 
egotripp: vc;VI VPNGsc VPP count vi 'egotrip' 
egresse: vc;statePhy vt 'egress' 
ejaculat: vc;VTH metabolize mkSound 'ejaculate' 
elaborat: A;VI VPP pt vt 'elaborate' 
elaps: vc;VI chgTime vi 'elapse' 
electrifi: vc;alive chgAttr promoteW vt 'electrify' 
electrifie: vc;alive chgAttr promoteW vt 'electrify' 
electrocut: vc;thing 'electrocute' 
electroplat: vc;count vt 'electroplate' 
elevat: vc;VI chgAttr moreC move vt 'elevate' 
eliminat: vc;VNPPP VNPPPas remove vt 'eliminate' 
elongat: vc;length 'elongate' 
elop: vc;VI VIrecip VPP leave 'elope' 
elucidat: vc;VNPPP VPP express 'elucidate' 
elud: vc;leave refuse vt 'elude' 
emanat: vc;VPP express statePhy vt 'emanate' 
emancipat: vc;VNPPP mkAct vt 'emancipate' 
emasculat: vc;enHidden 'emasculate' 
embarrasse: vc;VNPPNGoc VNPPP annoy causeNotDo pred vtPer 'embarrass' 
embedd: vc;VNPPP move vt 'embed' 
embellishe: vc;beautify chgGood 'embellish' 
embezzl: vc;VNPPP take vt 'embezzle' 
embodi: vc;VNPPP VNPPPas inclusive linkV vt 'embody' 
embodie: vc;VNPPP VNPPPas inclusive linkV vt 'embody' 
embrac: vc;VIrecip VNPPPas VerbNom count vacVO vt 'embrace' 
emce: vc;job v 'emcee' 
emerg: vc;VPP VPPas appear vAP vtoV 'emerge' 
emergencie: nc;abstract nt 'emergency' 
emigrat: vc;VI VPP VPPPP chgLoc vi 'emigrate' 
empanell: vc;enBe 'empanel' 
empathiz: vc;nAttitude 'empathize' 
emphasiz: vc;VHOWSS VNPPP VNPPPas VPPTH VSS VTH VhisNG express vacVO vt 'emphasize' 
emplac: vc;control vt 'emplace' 
empti: A;VI VNPPP VPP content count minusAmount situation vt 'empty' 
emptie: A;VI VNPPP VPP content count minusAmount situation vt 'empty' 
emulat: vc;VNPPP haveContest pt study vt 'emulate' 
emulsifi: vc;chgAttr 'emulsify' 
emulsifie: vc;chgAttr 'emulsify' 
enabl: vc;VNPTOoc VhisNG help mkAct vt 'enable' 
encapsulat: vc;chgQuant vt 'encapsulate' 
encas: vc;VNPPP cover enMove vt 'encase' 
encircl: vc;VNPPP coil from vt 'encircle' 
enclos: vc;VNPPP chgInclude coil vt 'enclose' 
encod: vc;VNPPP chgAttr express vt 'encode' 
encompasse: vc;VNPPP coil containV tWord vt 'encompass' 
encor: vc;abstract count vt 'encore' 
encourag: vc;VNPPNGoc VNPPP VNPTOoc VhisNG feeling help pEmo vtPer 'encourage' 
encroache: vc;VI VPP mkBad vi 'encroach' 
endors: vc;VNPPP VNPTOoc comfortW promoteW vt 'endorse' 
endu: vc;VNPPP chgPoss 'endue' 
endur: vc;VNG VNPNGoc VPPas goOn undergo vtoV 'endure' 
energiz: vc;alive chgState give promoteW 'energize' 
enervat: vc;attack chgProperty vt 'enervate' 
enfeebl: vc;chgProperty vt 'enfeeble' 
enforc: vc;chgGood vt 'enforce' 
enfranchis: vc;mkAct vt 'enfranchise' 
engag: vc;VIrecip VNPPP VNPPPas VNPTOoc VPNGsc VPP act haveContest tWord tie vtoV 'engage' 
englutt: vc;moveDown 'englut' 
engrav: vc;VNPPP express haveKnowledge 'engrave' 
engrosse: vc;behavior vt 'engross' 
enhanc: vc;VNPPP VhisNG chgGood chgQuant pt vacVO vt 'enhance' 
enkindl: vc;VI vt warmUp 'enkindle' 
enlac: vc; 'enlace' 
enlarg: vc;VI VPP chgMeasure moreC vt 'enlarge' 
enounc: vc;express 'enounce' 
enquir: vc;VNPPP VPP VPPPP VPPhowTO VPhisNG tryToKnow 'enquire' 
enrag: vc;annoy passion vtPer 'enrage' 
enraptur: vc;vt 'enrapture' 
enriche: vc;VNPPP improve vt 'enrich' 
enrob: vc; 'enrobe' 
ensconc: vc;VNPPP control vt 'ensconce' 
enshrin: vc;VNPPP vt 'enshrine' 
enslav: vc;VNPPP chgAttr mkBad vt 'enslave' 
ensnar: vc;VNPPP vt 'ensnare' 
ensu: vc;VI appear vi 'ensue' 
ensur: vc;VNPPPfor VSS VTH VhisNG mkAct pEmo tWord vacVO vt 'ensure' 
entangl: vc;VNPPP chg vt 'entangle' 
entic: vc;VNPPNGoc VNPPP VNPTOoc enDo vt 'entice' 
entitie: nc;vacFor 'entity' 
entitl: vc;VNPNP VNPPP VNPTOoc VRB enDo vt 'entitle' 
entrapp: vc;VNPPNGoc VNPPP mkMisunderstand take vt 'entrap' 
entrie: nc;VerbNom component 'entry' 
entwin: vc;VNPPP enMove vt 'entwine' 
enumerat: vc;calculate express vt 'enumerate' 
enunciat: vc;VNPPPas VRB mkSound vt 'enunciate' 
envi: vc;VNPNP VerbNom mental stateMental vt 'envy' 
envie: vc;VNPNP VerbNom mental stateMental vt 'envy' 
envisag: vc;VNPNG VNPPPas VNPTObe VSS deduce emo vt 'envisage' 
enwrapp: vc;VNPPP cover vt 'enwrap' 
epitomis: vc;chgAttr express 'epitomise' 
epitomiz: vc;chgAttr express vt 'epitomize' 
equalis: vc;chgCompare vt 'equalise' 
equaliz: vc;chgCompare vt 'equalize' 
equat: vc;VNPPP beSame chgCompare 'equate' 
equilibrat: vc;beSame 'equilibrate' 
equilibris: vc; 'equilibrise' 
equipp: vc;VNPPNGoc VNPPP VNPTOoc give pt vt 'equip' 
equivocat: vc;mkSound vt 'equivocate' 
eradicat: vc;VhisNG remove vt 'eradicate' 
erod: vc;VI lessC mkBad vt 'erode' 
escalad: vc;move 'escalade' 
escalat: vc;chgGrade 'escalate' 
escap: vc;VI VPP VPPPP VerbNom remove vVing vt 'escape' 
espi: vc;VNPNGoc haveKnowledge vt 'espy' 
espie: vc;VNPNGoc haveKnowledge vt 'espy' 
espous: vc;VhisNG pEmo perOrgV vacVO vt 'espouse' 
establishe: vc;VNPPNGoc VNPPP VNPPPas VNPRB VNPTObe VNPTOoc VPPhowTO VSS VTH VWHSS create tWord vt 'establish' 
esterifi: vc;chgAttr 'esterify' 
esterifie: vc;chgAttr 'esterify' 
estimat: vc;VNPPP VNPPPas VNPTObe VPP VSS VTH VWHSS VerbNom count vt 'estimate' 
estivat: vc;rest vt 'estivate' 
estopp: vc;causeNotDo 'estop' 
estrang: vc;VNPPP chgConnect timeOrSpace vt 'estrange' 
etche: vc;VNPPP express mkBad 'etch' 
eternalis: vc; 'eternalise' 
eternis: vc; 'eternise' 
etherealiz: vc;chgAttr 'etherealize' 
etherialis: vc; 'etherialise' 
etherifi: vc;chgAttr 'etherify' 
etherifie: vc;chgAttr 'etherify' 
etheris: vc;mkAct 'etherise' 
etheriz: vc;mkAct 'etherize' 
etiolat: vc;attack vt 'etiolate' 
eulogis: vc;pEmo 'eulogise' 
eulogiz: vc;VNPPPas VPP pEmo 'eulogize' 
europeanis: vc;vt 'europeanise' 
evacuat: vc;VNPPP VPP VPPPP move 'evacuate' 
evad: vc;leave refuse vt 'evade' 
evaluat: vc;VHOWSS VNPPNGoc VNPPP VNPPPas VWHSS VhisNG mkOwnKnowledge tWord vt 'evaluate' 
evangelis: vc; 'evangelise' 
evaporat: vc;VNPPP VPP move statePhy 'evaporate' 
evinc: vc;show vt 'evince' 
eviscerat: vc;chgForm vt 'eviscerate' 
evok: vc;CR VNPPP chgEmo vt 'evoke' 
evolv: vc;VI VNPPP VPP VPPPP appear beNormal promoteW succeed vt 'evolve' 
exacerbat: vc;mkAct troubleW vt worsen 'exacerbate' 
exaggerat: vc;VNPPP VPNGsc VPP VPPNG express 'exaggerate' 
examin: vc;VHOWSS VNPNGoc VNPPP VWHSS ask check infoV perOrgV vt 'examine' 
exasperat: vc;aggravateW vtPer 'exasperate' 
excavat: vc;chgForm take vt 'excavate' 
exchang: vc;VNPPP VPP VerbNom group vt 'exchange' 
excid: vc;chgForm 'excide' 
excis: vc;VNPPP abstract artifact remove vt 'excise' 
excit: vc;VNPPP emph happy passion promoteW vtPer 'excite' 
exclud: vc;VNPPNGoc VNPPP chgInclude inclusive send vt 'exclude' 
excommunicat: ;vt 'excommunicate' 
excoriat: vc;annoy mkOwnKnowledge vt 'excoriate' 
excret: vc;VNPPP metabolize vt 'excrete' 
exculpat: vc;VNPPP chgIsa vt 'exculpate' 
excus: vc;VNPPNGoc VerbNom count nt stateMental thinking vVing vt 'excuse' 
execrat: vc;VNPPPas nAttitude nt vt 'execrate' 
execut: vc;VNPPP VNPPPas VNPRB act vt 'execute' 
exemplifi: vc;VTH express vt 'exemplify' 
exemplifie: vc;VTH express vt 'exemplify' 
exercis: vc;VNPPP VerbNom 'exercise' 
exfoliat: vc;enAppear vt 'exfoliate' 
exhal: vc;VNPPP VPP moveOut 'exhale' 
exhilarat: vc;chgEmo vt 'exhilarate' 
exhum: vc;chgForm vt 'exhume' 
exil: vc;VNPPP VerbNom count per vt 'exile' 
exonerat: vc;VNPPNGoc VNPPP chgGood vt 'exonerate' 
exorcis: vc;VI VNPPP VPP enHidden 'exorcise' 
expatiat: vc;VPP express vt 'expatiate' 
expectorat: vc;moveOut 'expectorate' 
expedit: vc;chgMeasure vt 'expedite' 
experienc: vc;Key VNG VNPPPas VTH VWHSS VerbNom tWord vacOf vt 'experience' 
expiat: vc;resume vt 'expiate' 
expir: vc;end 'expire' 
explicat: vc;VNPPP VPPTH VTH VhisNG express vt 'explicate' 
explod: vc;VPP chgForm enAppear looksChg 'explode' 
explor: vc;VHOWSS VI VNG VPP VPPhowTO VWHSS infoV tWord vt 'explore' 
expositt: vc;express vt 'exposit' 
expostulat: vc;VI VPP VPPNG VPPPP VPhisNG enDo 'expostulate' 
expresse: A;APP VNPPP VWHSS abstract artifact count tWord vt 'express' 
expropriat: vc;VNPPP collect vt 'expropriate' 
expung: vc;VNPPP enHidden 'expunge' 
expurgat: vc;enHidden 'expurgate' 
extemporis: vc;mkSound vt 'extemporise' 
extemporiz: vc;mkSound 'extemporize' 
extenuat: vc;mkNoKnowledge vt 'extenuate' 
exterioris: vc;chgAttr vt 'exteriorise' 
exterioriz: vc;chgAttr vt 'exteriorize' 
exterminat: vc;remove vt 'exterminate' 
externalis: vc;chgAttr vt 'externalise' 
externaliz: vc;chgAttr vt 'externalize' 
extinguishe: vc;remove statePhy vt 'extinguish' 
extirpat: vc;moveOut remove vt 'extirpate' 
extradit: vc;VNPPP ceaseMove vt 'extradite' 
extrapolat: vc;VNPPP think vt 'extrapolate' 
extricat: vc;VNPPP enMove vt 'extricate' 
extrud: vc;VNPPP moveOut send vt 'extrude' 
exuberat: vc;chgPhy vt 'exuberate' 
exud: vc;VNPPP VPP moveOut vt 'exude' 
exudat: vc;moveOut vt 'exudate' 
exuviat: vc;ownNot 'exuviate' 
fabricat: vc;create vt 'fabricate' 
fac: vc;VI VNG VNPPP VPP VTH component looks reputation vt 'face' 
facilitat: vc;VhisNG chgGood promoteW vt 'facilitate' 
fagg: vc;VPP artifact count per vt 'fag' 
fak: A;VNG troubleW vt 'fake' 
falsifi: vc;chg create mkMisunderstand vt 'falsify' 
falsifie: vc;chg create mkMisunderstand vt 'falsify' 
familiariz: vc;VNPPP haveKnowledge vt 'familiarize' 
familie: nc;group per quant 'family' 
famishe: vc;VPP beBad undergo vt 'famish' 
fanci: A;VPP VSS coolC love vVing vt 'fancy' 
fancie: A;VPP VSS coolC love vVing vt 'fancy' 
fann: vc;VNPPP count emph passion 'fan' 
fascinat: vc;improve 'fascinate' 
faxe: vc;VerbNom count dative vt 'fax' 
faz: vc;mkBad 'faze' 
featherbedd: vc;VPP count 'featherbed' 
fecundat: vc;send vt 'fecundate' 
federalis: vc;associate vt 'federalise' 
federaliz: vc;associate vt 'federalize' 
federat: vc;VPP VPPas associate 'federate' 
felicitat: vc;VNPPNG VNPPNGoc VNPPP pEmo vt 'felicitate' 
fellat: vc;associate vt 'fellate' 
felonie: nc;count 'felony' 
feminis: vc;vt 'feminise' 
ferri: vc;VNPPP VPP count tool 'ferry' 
ferrie: vc;VNPPP VPP count tool 'ferry' 
fertilis: vc;send vt 'fertilise' 
fertiliz: vc;VNPPP metabolize send 'fertilize' 
fetche: vc;VNPPPfor abstract chgPoss 'fetch' 
fibb: vc;VI VPP abstract count vi 'fib' 
fictionalis: vc;produce vt 'fictionalise' 
fictionaliz: vc;produce vt 'fictionalize' 
fiddl: vc;VI VPP count vt 'fiddle' 
figur: vc;VHOWSS VNPPP VPP VPPNG VPhisNG VTH VWHSS VerbNom abstract count infosourceN looks vt vtoV 'figure' 
fil: vc;VNPAP VNPPP VPP count tool vt 'file' 
filche: vc;VNPPP take vt 'filch' 
filtrat: vc;VNPPP VPP artifact 'filtrate' 
finalis: vc;mkOwnKnowledge vt 'finalise' 
finaliz: vc;mkOwnKnowledge vt 'finalize' 
financ: vc;VNPPP VerbNom useC vt 'finance' 
fine-tun: vc;hyphenated mkBetter 'fine-tune' 
finishe: vc;VI VNG VNPPP VNPPPas VPP VPPas VerbNom act component statePhy vAP vVing vt 'finish' 
fishe: vc;VPP VRB animal artifact sgPlu 'fish' 
fissur: vc;component count v 'fissure' 
fitt: A vc;APP ATO VI VNPPP VPP VRB VerbNom count pt stateMental vt vtoV 'fit' 
fixat: vc;VNPPP VPNGsc VPP sense vt 'fixate' 
fixe: vc;VI VNPPPfor VNPRB VPP VerbNom correctW count improve vt 'fix' 
fizzl: vc;VI VPP abstract tWord vi 'fizzle' 
flagellat: vc;VI vt 'flagellate' 
flai: vc;VNPPP vt 'flay' 
flaie: vc;VNPPP vt 'flay' 
flamm: nc;thinking v 'flam' 
flang: vc;count prod v 'flange' 
flapp: vc;VPP VerbNom component count vt 'flap' 
flar: vc;VI VPP natural prod vt 'flare' 
flash-freez: vc;chgMeasure hyphenated 'flash-freeze' 
flashe: vc;VI VNPPP VPPdir time vt 'flash' 
fle: vc;VNPPP VPP VPPPP VPPdir leave 'flee' 
fledg: vc;appear 'fledge' 
fleshe: vc;bodyPart component v 'flesh' 
flexe: A nc vc;abstract 'flex' 
fli: vc;VI VNPPPPP VNPPPdir VNPRB VPP VPPPPdir VPPdir VRB animal useC vt 'fly' 
flie: vc;VI VNPPPPP VNPPPdir VNPRB VPP VPPPPdir VPPdir VRB animal useC vt 'fly' 
flinche: vc;VPNGsc VPP move 'flinch' 
flip-flopp: A vc;hyphenated 'flip-flop' 
flipp: A nc vc;AitPPforTO VNPPP VPP count vt 'flip' 
flitt: vc;VI abstract count move vi 'flit' 
flogg: vc;chgForm vt 'flog' 
flopp: vc;VI count natural v 'flop' 
flosse: vc;tWord 'floss' 
flounc: vc;VI count v 'flounce' 
flourishe: vc;VI abstract count v 'flourish' 
flubb: vc;v 'flub' 
fluctuat: vc;VI VPNGsc VPP chg volition 'fluctuate' 
flummoxe: nc vc;annoy 'flummox' 
fluoridat: vc;chgAttr vt 'fluoridate' 
fluoridis: vc;chgAttr vt 'fluoridise' 
fluoridiz: vc;chgAttr vt 'fluoridize' 
flushe: A vc;APP RB VNPPP abstract color count time vt 'flush' 
fly-fishe: vc;VI VPP hyphenated vi 'fly-fish' 
fobb: vc;component 'fob' 
focalis: vc;vt 'focalise' 
focuse: vc;VI VNPPP VPNGsc VPP VPPNG VerbNom component count onV pt space vt 'focus' 
fogg: vc;natural vt weather 'fog' 
foliat: A;a enBe 'foliate' 
fondl: vc;chgForm vt 'fondle' 
footslogg: vc;VI move vi 'footslog' 
forbidd: vc;VNPPNG VNPTOoc causeNotDo remove vt 'forbid' 
forc: vc;Nom VNPAP VNPPNGoc VNPPP VNPTOoc abstract group strength vt vtoV 'force' 
forebod: vc;beC vt 'forebode' 
foreclos: vc;VPP aggravateW causeNotDo perOrgV 'foreclose' 
forese: vc;VNPAP VNPEN VNPNGoc VNPPPas VTH deduce vt 'foresee' 
forg: vc;VPP VRB count vt 'forge' 
forgett: vc;VHOWSS VI VNG VNPNGoc VPP VPhisNG VSS VWHSS noKnowledge perV vt vtoV 'forget' 
forgiv: vc;VNPPNGoc VNPPP nAttitude perV vVing vtPer 'forgive' 
formalis: vc;chgAttr vt 'formalise' 
formaliz: vc;chgAttr vt 'formalize' 
formulariz: vc;chgAttr 'formularize' 
formulat: vc;chgProperty express mkAct tWord vt 'formulate' 
fornicat: vc;VI VPP vi 'fornicate' 
forsak: vc;VNG VNPPP give vt 'forsake' 
fortifi: vc;chgProperty haveContest promoteW vt 'fortify' 
fortifie: vc;chgProperty haveContest promoteW vt 'fortify' 
fossilis: vc;behavior vt 'fossilise' 
fossiliz: vc;behavior 'fossilize' 
fractur: vc;VI phenomena space vt 'fracture' 
fragmentis: vc;chgConnect 'fragmentise' 
fragmentiz: vc;chgConnect 'fragmentize' 
fram: vc;component count quant vt 'frame' 
franchis: vc;VerbNom com count 'franchise' 
frapp: vc;cover 'frap' 
frazzl: vc;abstract count v 'frazzle' 
fre: A;APP ATO AitPPforTOomit RB VNPPNGoc VNPPP VNPTOoc price pro situation up vt 'free' 
freckl: vc;VNPPP count nt 'freckle' 
freez: vc;VI VNPAP VNPPP VPP VRB VerbNom count vt 'freeze' 
freeze-dri: vc;hyphenated ill 'freeze-dry' 
freeze-drie: vc;hyphenated ill 'freeze-dry' 
frenchifi: vc;chgAttr 'frenchify' 
frenchifie: vc;chgAttr 'frenchify' 
frett: vc;VI VPP VTH annoy vt 'fret' 
frie: vc;VNPPP VPP animal count 'fry' 
frigg: vc;associate 'frig' 
frizzl: vc;vt 'frizzle' 
frolick: vc;VIrecip VPP abstract v 'frolic' 
fructifi: vc;create succeed 'fructify' 
fructifie: vc;create succeed 'fructify' 
frustrat: vc;annoy causeNotDo passion vtPer weakPI 'frustrate' 
fuddl: vc;annoy passion vt 'fuddle' 
fudg: vc;v 'fudge' 
fulminat: vc;artifact 'fulminate' 
fum: vc;VPP VTH count natural 'fume' 
fumbl: vc;VPP VPPPP VPPdir abstract 'fumble' 
fumigat: vc;chgAttr vt 'fumigate' 
fund-rais: vc;hyphenated take 'fund-raise' 
fundrais: vc;take 'fundraise' 
funnell: vc;VNPPP VPP component count tool 'funnel' 
furcat: vc;vt 'furcate' 
furnishe: vc;VNPPPfor VNPRB dative give vt 'furnish' 
fus: vc;VIrecip VPP component count prod tool 'fuse' 
fusse: vc;VI VPNGsc VPP VPPNG abstract count nt stateMental vi 'fuss' 
gadd: vc;VI VRB abstract component nt vi 'gad' 
gagg: vc;VNPPP VPP count 'gag' 
gallerie: nc;artifact component count 'gallery' 
galvanis: vc;promoteW vt 'galvanise' 
galvaniz: vc;chgEmo chgLooks promoteW vt 'galvanize' 
gambl: vc;VPP VTH VerbNom count 'gamble' 
gamboll: vc;VI abstract count vi 'gambol' 
gamm: vc;abstract v 'gam' 
gang-rap: vc;enDo hyphenated 'gang-rape' 
gaoll: vc;count group v 'gaol' 
garbl: vc;chg vt 'garble' 
gargl: vc;VI VPP cleanse useC 'gargle' 
garnishe: vc;VNPPP beautify vt 'garnish' 
garott: vc;count vt 'garotte' 
garrot: ;v 'garrote' 
garrott: vc;count vt 'garrotte' 
gasconad: vc;abstract v 'gasconade' 
gase: vc;VI VNPPhisNG solution vt 'gas' 
gasifi: vc;chgAttr 'gasify' 
gasifie: vc;chgAttr 'gasify' 
gate-crashe: vc;hyphenated take 'gate-crash' 
gatecrashe: vc;VI vt 'gatecrash' 
gaug: vc;VHOWSS VNPPP VWHSS count length tool vt 'gauge' 
gaz: vc;VI VPP abstract count vi 'gaze' 
gazett: vc;VTH artifact count vt 'gazette' 
gelatinis: vc; 'gelatinise' 
geminat: A;quant vt 'geminate' 
generalis: vc;chgAttr vt 'generalise' 
generaliz: vc;VNPPP VPP VPPPP chgAttr express 'generalize' 
generat: vc;appear causeV create vt 'generate' 
germinat: vc;VI VPP create moreC vt 'germinate' 
gestat: vc;beNormal vt 'gestate' 
gesticulat: vc;VI mkOthersKnowledge 'gesticulate' 
gett: vc;VNG VNPAP VNPEN VNPNGoc VNPPPas VNPPPdir VNPPPfor VNPRB VNPTOoc VPPdir VRB linkV vAP vacVO vt vtoV xC 'get' 
ghostwrit: vc;express 'ghostwrite' 
gibb: vc;animal v 'gib' 
giggl: vc;VI VTH count 'giggle' 
gitt: vc;per v 'git' 
giv: vc;VNPPPas VPP abstract dative pt vacVO 'give' 
glaciat: vc;looksChg vt 'glaciate' 
glamoris: vc;vt 'glamorise' 
glamoriz: vc;radiant vt 'glamorize' 
glamouris: vc;vt 'glamourise' 
glanc: vc;VI VPP VPPPP VerbNom count mental 'glance' 
glar: vc;VI VPP VerbNom v 'glare' 
glaz: vc;artifact natural 'glaze' 
glid: vc;VNPPP VPP abstract count natural prod0 'glide' 
glimps: vc;VNPPP VerbNom count vt 'glimpse' 
globalis: vc;chgAttr vt 'globalise' 
globaliz: vc;VNPPP VPP chgAttr 'globalize' 
globetrott: vc;VI vi 'globetrot' 
glomm: vc;take 'glom' 
glori: vc;VI VPP abstract natural vi 'glory' 
glorie: vc;VI VPP abstract natural vi 'glory' 
glorifi: vc;VNPPP chgState pEmo vt 'glorify' 
glorifie: vc;VNPPP chgState pEmo vt 'glorify' 
glosse: vc;abstract count natural 'gloss' 
glu: vc;VRB prod 'glue' 
glugg: vc; 'glug' 
glutt: vc;VNPPP abstract count nt vt 'glut' 
glycerolis: vc; 'glycerolise' 
gobbl: vc;abstract count vt 'gobble' 
goe: vc;VI VNG VPNGsc VPP VPPPP VPPdir VRB tWord vAP vVing vi vtoV xC 'go' 
googl: vc;tryToKnow 'google' 
gor: vc;VNPPP component vt 'gore' 
goug: vc;VNPPP count natural tool vt 'gouge' 
grabb: vc;VNPPP VPP VerbNom count vt 'grab' 
grac: vc;VNPPP demeanor mental vt 'grace' 
gradat: vc; 'gradate' 
graduat: vc;Nom VI VNPPP VPP VPPPP count modJJ per vAP vt 'graduate' 
granulat: vc;chgForm 'granulate' 
grappl: vc;VI VPP tool v 'grapple' 
grat: vc;VNPPP VPP component count 'grate' 
gratifi: vc;mkAct vt 'gratify' 
gratifie: vc;mkAct vt 'gratify' 
gravitat: vc;VI VPP VRB pEmo vi 'gravitate' 
graz: vc;VNPPP abstract count 'graze' 
griddl: vc;tool 'griddle' 
griev: vc;VI VPP VPhisNG nEmo 'grieve' 
grimac: vc;VI count looks vi 'grimace' 
grinn: vc;VI VPPPP count 'grin' 
gritt: vc;VPP natural prod 'grit' 
grizzl: vc;VI 'grizzle' 
grop: vc;VNPPPdir VPP abstract tryToKnow 'grope' 
grouche: vc;VI count per vi 'grouch' 
grous: vc;VI VPP n vi 'grouse' 
grovell: vc;VI VPP move obey vi 'grovel' 
grubb: vc;VNPPP VPP animal 'grub' 
grumbl: vc;VI VPP VTH abstract count nt stateMental 'grumble' 
gruntl: vc;chgEmo 'gruntle' 
guarante: vc;VI VNPPP VNPSS VNPTOoc VSS VTH VerbNom count dative pt vacOf vacTo vt 'guarantee' 
guesse: vc;VHOWSS VI VNPAP VNPPP VPP VRB VSS VTH VWHSS VerbNom count vt 'guess' 
guesstimat: vc;abstract count v 'guesstimate' 
guestimat: vc;abstract v 'guestimate' 
guid: vc;Nom VI VNPPPdir VNPRB VNPTOoc VPP VhisNG component count vacTo vt 'guide' 
gumm: vc;VI component prod vt waste 'gum' 
gunn: vc;component count prod tool vt 'gun' 
gurgl: vc;VI count natural v 'gurgle' 
gushe: vc;VI VPP abstract count goOut 'gush' 
gutt: vc;Nom component count vt vtoV 'gut' 
guzzl: vc;vt 'guzzle' 
gyrat: vc;VI VPP chg 'gyrate' 
habituat: vc;CR VI VNPPP suit vt 'habituate' 
haggl: vc;VIrecip VPP VPPPP abstract 'haggle' 
hallucinat: vc;vt 'hallucinate' 
halogenat: vc;chgAttr 'halogenate' 
halv: vc;vt 'halve' 
hand-washe: vc;clean hyphenated 'hand-wash' 
handicapp: vc;botchW causeNotDo ill vt 'handicap' 
handl: vc;VRB component count pt thinking vt 'handle' 
handstitche: vc; 'handstitch' 
handwashe: vc;clean 'handwash' 
handwrit: vc;express 'handwrite' 
happ: vc;count 'hap' 
harangu: vc;VNPPP VerbNom count vt 'harangue' 
harasse: vc;VNPPP VPhisNG annoy mkBad vtPer 'harass' 
harmonis: vc;VIrecip VPP chgFit persuade suit 'harmonise' 
harmoniz: vc;VI VIrecip VPP chgFit persuade suit 'harmonize' 
harnesse: vc;VNPPP VNPPPas VerbNom artifact count ness vt 'harness' 
harri: vc;VNPPP take vt 'harry' 
harrie: vc;VNPPP take vt 'harry' 
hatche: vc;component count 'hatch' 
healthifi: vc;improve 'healthify' 
healthifie: vc;improve 'healthify' 
heav: vc;VNPPPdir abstract count vt 'heave' 
hedg: ;VPP component count n 'hedge' 
hedgehopp: vc;VI move 'hedgehop' 
hemstitche: vc;count vt 'hemstitch' 
hesitat: vc;VI VPP vi vtoV 'hesitate' 
heterodyn: A;performance 'heterodyne' 
hexe: vc;abstract ebla v 'hex' 
hibernat: vc;VI VPP rest vi 'hibernate' 
hiccupp: vc;VI sufferFrom vi 'hiccup' 
higgl: vc;communicate 'higgle' 
high-hatt: vc;behavior hyphenated 'high-hat' 
hik: vc;VI VPP VPPPP VPPdir VerbNom count moreC 'hike' 
hing: vc;VPP component count prod tool 'hinge' 
hisse: vc;VI VPP VTH abstract count natural 'hiss' 
hitche: vc;VIrecip VNPPP VPP VRB abstract count vt 'hitch' 
hitt: nc vc;VBDN VI VNPPP VNPRB VPP VRB VerbNom count vt 'hit' 
hoaxe: vc;VNPPhisNG count nt thinking vt 'hoax' 
hobbl: vc;VPPdir count move nt 'hobble' 
hobnobb: vc;VI VPP associate vi 'hobnob' 
hol: vc;abstract component count 'hole' 
hom: vc;artifact 'home' 
homogenis: vc;VNPPP content vt 'homogenise' 
homogeniz: vc;VNPPP content vt 'homogenize' 
homologis: vc;pertinence 'homologise' 
homologiz: vc;pertinence 'homologize' 
hopp: vc;VI VPPdir abstract count plant 'hop' 
horrifi: vc;VNPPP VPPNG annoy emph passion vtPer 'horrify' 
horrifie: vc;VNPPP VPPNG annoy emph passion vtPer 'horrify' 
horsewhipp: vc;artifact count vt 'horsewhip' 
hos: vc;prod vt 'hose' 
hospitalis: vc;VNPPP ceaseMove vt 'hospitalise' 
hospitaliz: vc;VNPPP ceaseMove vt 'hospitalize' 
hot-presse: vc;chgForm hyphenated 'hot-press' 
hous: vc;VNPPP artifact count group vt 'house' 
housebrok: vc;behavior past 'housebroke' 
huddl: vc;VI abstract count 'huddle' 
hugg: vc;VIrecip VerbNom count 'hug' 
humanis: vc;chgAttr vt 'humanise' 
humaniz: vc;chgAttr vt 'humanize' 
humbl: A;quality rank vt 'humble' 
humbugg: vc;abstract vt 'humbug' 
humidifi: vc;chgMeasure damp 'humidify' 
humidifie: vc;chgMeasure damp 'humidify' 
humifi: vc;chgMeasure 'humify' 
humifie: vc;chgMeasure 'humify' 
humiliat: vc;annoy mkBad vtPer 'humiliate' 
humm: vc;abstract count natural 'hum' 
hunche: vc;abstract count 'hunch' 
hurdl: vc;count nt vt 'hurdle' 
hurri: vc;VPP VerbNom speed 'hurry' 
hurrie: vc;VPP VerbNom speed 'hurry' 
hurtl: vc;VI 'hurtle' 
hushe: vc;abstract count lessC situation vt 'hush' 
hustl: vc;VNPPPdir VPP VPPdir abstract 'hustle' 
hybridiz: vc;associate vt 'hybridize' 
hydrat: vc;artifact pt 'hydrate' 
hydrolis: vc; 'hydrolise' 
hydrolys: vc;looksChg 'hydrolyse' 
hydrolyz: vc;looksChg 'hydrolyze' 
hydroplan: vc;count tool 'hydroplane' 
hygienis: vc; 'hygienise' 
hyperventilat: vc;ill vt 'hyperventilate' 
hyphenat: vc;tie vt 'hyphenate' 
hypnotis: vc;enDo 'hypnotise' 
hypnotiz: vc;VNPPP mkBad vt 'hypnotize' 
hypostatis: vc;chgAttr vt 'hypostatise' 
hypostatiz: vc;chgAttr vt 'hypostatize' 
hypothecat: vc;VNPPP give vt 'hypothecate' 
hypothesiz: vc;VTH enBe 'hypothesize' 
idealiz: vc;quality vt 'idealize' 
ideat: vc;tryToKnow vt 'ideate' 
identifi: vc;VNPPNGoc VNPPP VNPPPas VNPPhisNG VNPasEN VPP infoV tWord up1 vt 'identify' 
identifie: vc;VNPPNGoc VNPPP VNPPPas VNPPhisNG VNPasEN VPP infoV tWord up1 vt 'identify' 
idl: A vc;VI a abstract vt 'idle' 
ignit: vc;VNPPP VNPPhisNG warmUp 'ignite' 
ignor: vc;nAttitude vt 'ignore' 
illegalis: vc; 'illegalise' 
illud: vc; 'illude' 
illum: vc; 'illume' 
illuminat: vc;VNPPP chgLooks express vt 'illuminate' 
illustrat: vc;VNPPP VNPPPas VPPhowTO VTH VWHSS express 'illustrate' 
imbedd: vc;VNPPP moveIn 'imbed' 
imbib: vc;metabolize 'imbibe' 
imbru: vc;playDown 'imbrue' 
imbu: vc;VNPPP mkOthersKnowledge move moveIn vt 'imbue' 
imitat: vc;VNPNGoc study vt write 'imitate' 
immaterialis: vc; 'immaterialise' 
immers: vc;VNPPP appear moveIn vt 'immerse' 
immigrat: vc;VI VPP chgLoc 'immigrate' 
immixe: vc;tie 'immix' 
immobilis: vc;vt 'immobilise' 
immolat: vc;vt 'immolate' 
immortalis: vc;VNPPP VNPPPas dur vt 'immortalise' 
immortaliz: vc;VNPPP VNPPPas dur vt 'immortalize' 
immunis: vc;VNPPP VPP pt resume vtPer 'immunise' 
immunitie: nc;ebla mental 'immunity' 
immuniz: vc;VNPPP VPP causeNotDo pt resume vtPer 'immunize' 
immur: vc;VNPPP ceaseMove vt 'immure' 
impal: vc;VNPPP vt 'impale' 
impeache: vc;VNPPNGoc VNPPP annoy express nAttitude vtPer 'impeach' 
imped: vc;VNPPNGsc VNPPP attack causeNotDo lessC vt 'impede' 
impell: vc;VNPPP VNPTOoc enDo vt 'impel' 
impersonat: vc;VNPPPas vt 'impersonate' 
imping: vc;VI VPP chgForm 'impinge' 
impli: vc;VNPPP VSS inclusive linkV tWord vt 'imply' 
implicat: vc;VNPPP VNPPPas connective vt 'implicate' 
implie: vc;VNPPP VSS inclusive linkV tWord vt 'imply' 
implod: vc; 'implode' 
implor: vc;VNPTOoc seek vt 'implore' 
importun: A vc;VNPPP seek vt 'importune' 
impos: vc;VNPPP VPP collect 'impose' 
impoverishe: vc;nt situation vt 'impoverish' 
imprecat: vc;annoy 'imprecate' 
impregnat: A vc;VNPPP VNPPhisNG looksChg mkAct send vt 'impregnate' 
impresse: vc;VNPPP VNPPPas VPPTH abstract count emph happy passion 'impress' 
improv: vc;VI VNPPP VPNGsc VPP VPPas improve vt 'improve' 
improvis: vc;mkSound 'improvise' 
improviz: vc;mkSound 'improvize' 
inactivat: vc;VNPPP enHidden 'inactivate' 
inaugurat: vc;VNPPPas act statePhy vt 'inaugurate' 
incandesc: vc;chgAttr vt 'incandesce' 
incapacit: vc; 'incapacite' 
incapacitat: vc;VI attack enHidden 'incapacitate' 
incapsulat: vc; 'incapsulate' 
incarcerat: vc;VNPPP vt 'incarcerate' 
incarnadin: vc;chgLooks 'incarnadine' 
incarnat: A vc;VNPPP VNPPPas beC vt 'incarnate' 
incinerat: vc;VI vt warmUp 'incinerate' 
incis: vc;VNPPP chgForm vt 'incise' 
incit: vc;VNPPP VNPTOoc enDo vt 'incite' 
inclin: vc;VNPPP VNPPhisNG VNPTOoc VPP count vtoV 'incline' 
incommod: vc;causeNotDo vt 'incommode' 
inconvenienc: vc;VNPPP VerbNom problem troubleW vt 'inconvenience' 
incorporat: vc;VI VIrecip VNPPP VNPPPas VNPRB VPP associate inclusive vt 'incorporate' 
increas: vc;VI VNPPP VPP VerbNom moreC statePhy vt 'increase' 
incriminat: vc;VNPPNGoc VNPPP express nAttitude vtPer 'incriminate' 
incubat: vc;create 'incubate' 
inculcat: vc;VNPPP mkOthersKnowledge vt 'inculcate' 
incurr: vc;VNPPP VNPPhisNG chgCR undergo vt 'incur' 
indemnifi: vc;VNPPP give vt 'indemnify' 
indemnifie: vc;VNPPP give vt 'indemnify' 
indexe: vc;VNPPP VNPPPas count vt 'index' 
indicat: vc;VHOWSS VNPPP VPPTH VSS VTH VWHSS linkV mkOthersKnowledge tWord vt 'indicate' 
indispos: vc;attack chgFit nAttitude vt 'indispose' 
individualis: vc;chgAttr vt 'individualise' 
individualiz: vc;chgAttr vt 'individualize' 
individuat: vc;chgAttr vt 'individuate' 
indoctrinat: vc;VNPPP mkOthersKnowledge vt 'indoctrinate' 
indors: vc;VNPPP VNPPPas VNPRB tWord vt 'indorse' 
indu: vc;VNPPP chgPoss vt 'indue' 
induc: vc;VNPPP VNPPhisNG VNPTOoc VhisNG causeV vt 'induce' 
indulg: vc;VNPPP VNPPPas VPNGsc VPP fondOf 'indulge' 
indurat: A vc;soft vt 'indurate' 
industrialis: vc;chgAttr vt 'industrialise' 
industrializ: vc;chgAttr 'industrialize' 
industrie: nc;count org vacFor vacOf 'industry' 
inebriat: A;VNPPP count injureW per vt 'inebriate' 
infatuat: vc;VNPPP VNPPhisNG behavior vt 'infatuate' 
inferr: vc;VPPTH VPPhowTO VTH deduce vt 'infer' 
infiltrat: vc;CR chgInclude move vt 'infiltrate' 
infixe: vc;abstract v 'infix' 
inflam: vc;aggravateW ill vt 'inflame' 
inflat: vc;VNPPP chgMeasure metabolize vt 'inflate' 
influenc: vc;CR VHOWSS VNPPP VNPPPas VNPTOoc VWHSS VerbNom effectivity tWord vacOf vt 'influence' 
infring: vc;VI VPP chgFit 'infringe' 
infuriat: vc;VNPPP VNPPhisNG annoy vtPer 'infuriate' 
infus: vc;VNPPP metabolize mkOthersKnowledge moveIn 'infuse' 
ingratiat: vc;VNPPP please vt 'ingratiate' 
ingurgitat: vc;metabolize 'ingurgitate' 
inhal: vc;moveIn 'inhale' 
inher: vc;appear vt 'inhere' 
inhum: vc;moveIn vt 'inhume' 
initialis: vc;chgAttr vt 'initialise' 
initializ: vc;chgAttr vt 'initialize' 
initiat: vc;APP CR VNPPP VNPPPas VNPPhisNG act count per statePhy up1 vt 'initiate' 
injur: vc;VNPNGsc VNPPP VNPPhisNG injureW mkBad vt 'injure' 
injurie: nc;VerbNom phenomena 'injury' 
innervat: vc;vt 'innervate' 
innoculat: vc;resume 'innoculate' 
innovat: vc;mkBetter pt 'innovate' 
inoculat: vc;VNPPP resume vt 'inoculate' 
inquir: vc;VNPPP VPP VPPPP VPPhowTO VPhisNG check perOrgV 'inquire' 
inscrib: vc;VNPPP VPP write 'inscribe' 
insecuritie: nc;abstract 'insecurity' 
inseminat: vc;VNPPP send vt 'inseminate' 
insett: nc vc;VBDN VNPPP component count phy vt 'inset' 
insinuat: vc;VNPPP VSS VTH annoy linkV vt 'insinuate' 
insolat: vc;chgLooks vt 'insolate' 
inspir: vc;VNPPP VNPPPas VNPTOoc chgEmo vt 'inspire' 
inspissat: vc;looksChg vt 'inspissate' 
instantiat: vc;vt 'instantiate' 
instigat: vc;VNPPP VNPPhisNG enDo vt 'instigate' 
institutionalis: vc; 'institutionalise' 
insufflat: vc;moveIn vt 'insufflate' 
insulat: vc;VNPPP chgConnect vt 'insulate' 
insur: vc;VNPPP VSS VTH pEmo tWord take vacVO vt 'insure' 
integrat: vc;VIrecip VNPPP VNPPPas VPP tie 'integrate' 
intellectualiz: vc;chgAttr 'intellectualize' 
intensifi: vc;VI chgAttr mkAct moreC vt 'intensify' 
intensifie: vc;VI chgAttr mkAct moreC vt 'intensify' 
interced: vc;VI VPP persuade vi 'intercede' 
interchang: vc;VIrecip VPP component count vt 'interchange' 
interfac: vc;count tool v 'interface' 
interioriz: vc;behavior 'interiorize' 
interlac: vc;VIrecip VPP enMove vt 'interlace' 
interleav: vc;vt 'interleave' 
interlop: vc; 'interlope' 
intermarri: vc;VI VIrecip VPP associate 'intermarry' 
intermarrie: vc;VI VIrecip VPP associate 'intermarry' 
intermingl: vc;VIrecip VPP tie vt 'intermingle' 
intermitt: vc;act vt 'intermit' 
intermixe: vc;VIrecip VPP tie 'intermix' 
internationalis: vc;chgAttr vt 'internationalise' 
internationaliz: vc;VNPPPas chgAttr vt 'internationalize' 
interpellat: vc;VNPPP ask vt 'interpellate' 
interpolat: vc;VNPPP chgQuant tie 'interpolate' 
interpos: vc;VPP chg 'interpose' 
interr: vc;VNPPP moveIn vt 'inter' 
interrogat: vc;VNPPP ask vt 'interrogate' 
interspers: vc;VNPPP tie 'intersperse' 
intertwin: vc;VIrecip VPP mkBad move 'intertwine' 
interven: vc;VI VPP mkBad persuade vi 'intervene' 
interweav: vc;VIrecip VNPPP VPP tie vt 'interweave' 
intimat: A vc;VPPhowTO VTH count per vt 'intimate' 
intimidat: vc;VNPPhisNG annoy passion vtPer weakPI 'intimidate' 
inton: vc;mkSound 'intone' 
intoxicat: vc;VNPPP pEmo vt 'intoxicate' 
intransitivis: vc; 'intransitivise' 
intrigu: vc;VNPPPas abstract happy mkOwnKnowledge pred vtPer 'intrigue' 
introduc: vc;VNPPP VNPPPas express tWord vacVO vt 'introduce' 
intromitt: vc;move vt 'intromit' 
intrud: vc;VI VPP mkBad 'intrude' 
intubat: vc;move vt 'intubate' 
inundat: vc;VNPPP goOut vt 'inundate' 
inur: vc;VNPPP suit vt 'inure' 
invad: vc;VI VNPPP aggravateW mkBad move vt 'invade' 
invalidat: vc;VNPPPas beBad vt 'invalidate' 
inveigl: vc;VNPPP enDo vt 'inveigle' 
investigat: vc;VI VNPPP VNPPPas VPPhowTO VWHSS check infoV perOrgV vt 'investigate' 
invigilat: vc;check vt 'invigilate' 
invigorat: vc;VNPPP chgGood chgState promoteW vt 'invigorate' 
invit: vc;CR VNPPP VNPPPas VNPTOoc abstract count use vtPer 'invite' 
invocat: vc; 'invocate' 
invoic: vc;VNPPP abstract count vt 'invoice' 
invok: vc;VNPPP express mkAct vt 'invoke' 
involv: vc;CR VNPPNGoc VNPPP VNPPPas VNPPhisNG VhisNG chgConnect inclusive tWord vVing vt 'involve' 
inweav: vc;chgForm 'inweave' 
iodinat: vc; 'iodinate' 
iodiz: vc;vt 'iodize' 
ionis: vc;component 'ionise' 
ioniz: vc;component 'ionize' 
iridesc: vc;radiant vt 'iridesce' 
irradiat: vc;chgLooks mkOthersKnowledge vt 'irradiate' 
irrigat: vc;moisten 'irrigate' 
irritat: vc;aggravateW annoy passion vtPer 'irritate' 
isolat: vc;VI VNPPP VNPPPas chgConnect tWord vt 'isolate' 
isomeris: vc;chgAttr vt 'isomerise' 
isomeriz: vc;chgAttr vt 'isomerize' 
issu: vc;Nom VI VPP bad count dative problem vt 'issue' 
italicis: vc; 'italicise' 
itche: vc;VI nt phenomena vt vtoV 'itch' 
itemis: vc;express vt 'itemise' 
itemiz: vc;express vt 'itemize' 
iterat: vc;act 'iterate' 
itinerat: vc;move 'itinerate' 
jabb: vc;VI VNPPP VPP VerbNom count vt 'jab' 
jaculat: vc;move 'jaculate' 
jamm: vc;VI VNPAP VNPPP VPP VerbNom artifact nt statePhy vt 'jam' 
jangl: vc;VPP abstract 'jangle' 
jeopardis: vc;mkBad worsen 'jeopardise' 
jeopardiz: vc;VNPPNGsc VNPPP VhisNG mkBad vt worsen 'jeopardize' 
jibb: vc;VNPPP VPNGsc VPP count 'jib' 
jiggl: vc;VNPAP abstract count 'jiggle' 
jinxe: vc;count per v 'jinx' 
jiv: vc;VPP abstract info 'jive' 
jogg: vc;VNPPPdir VPP VPPdir abstract count 'jog' 
joggl: vc;count 'joggle' 
jok: vc;Nom VI VPP VPPNG VPPPP VPPTH VPhisNG VTH count passion perV vi weakPI 'joke' 
jollifi: vc;pt vt 'jollify' 
jollifie: vc;pt vt 'jollify' 
joshe: vc;please 'josh' 
jostl: vc;VNPPPdir VPP VPPPP VPPdir abstract enMove vt 'jostle' 
joyrid: vc;abstract 'joyride' 
jubilat: vc;mkSound vt 'jubilate' 
judg: vc;VHOWSS VI VNPAP VNPNP VNPPNGoc VNPPP VNPPPas VNPTObe VNPasAP VPP VPPhowTO VSS VTH VWHSS count job vt 'judge' 
juggl: vc;VPP abstract annoy mkMisunderstand show 'juggle' 
jumbl: vc;VPP vt 'jumble' 
jurie: nc;count org 'jury' 
justifi: vc;VHOWSS VI VNPNG VNPPNGoc VNPPP VNPPPas VPPTH VWHSS VhisNG communicate mkOwnKnowledge vt 'justify' 
justifie: vc;VHOWSS VI VNPNG VNPPNGoc VNPPP VNPPPas VPPTH VWHSS VhisNG communicate mkOwnKnowledge vt 'justify' 
jutt: vc;VPP abstract statePhy v 'jut' 
juxtapos: vc;VIrecip VNPPP VPP from 'juxtapose' 
keratinis: vc;vt 'keratinise' 
keynot: vc;abstract content count modJJ natural 'keynote' 
kiboshe: vc;chg 'kibosh' 
kidd: vc;VI VNPPNGoc VNPPP animal count per vt 'kid' 
kidnapp: vc;move take vt 'kidnap' 
kindl: vc;VNPPP warmUp 'kindle' 
kipp: vc;VI abstract count vi 'kip' 
kisse: vc;VIrecip VNPPP count perV vt 'kiss' 
knapp: vc;chgForm 'knap' 
knitt: vc;VBDN VNPPPfor chgForm move vt 'knit' 
knuckl: vc;component count 'knuckle' 
kvetche: vc;per v 'kvetch' 
labell: vc;VNPAP VNPNP VNPPP VNPPPas VNPasAP artifact count vt 'label' 
labialis: vc;express 'labialise' 
labializ: vc;express 'labialize' 
lacerat: vc;chgConnect vt 'lacerate' 
ladie: nc;count per 'lady' 
lagg: A vc;VPP VerbNom count nt troubleW 'lag' 
laiciz: vc;statePhy vt 'laicize' 
lallygagg: vc;act 'lallygag' 
laminat: vc;VNPPP prod vt 'laminate' 
lancinat: vc;chgForm 'lancinate' 
landscap: vc;count scene 'landscape' 
languishe: vc;VI VPP fat situation suffer vi volition 'languish' 
lapidifi: vc;chgAttr 'lapidify' 
lapidifie: vc;chgAttr 'lapidify' 
larrupp: vc;chgForm 'larrup' 
lashe: vc;VPP component count tool vt 'lash' 
latche: vc;VPP component count prod tool vt 'latch' 
latinis: vc; 'latinise' 
launche: vc;VNPPP VPP VerbNom act count perOrgV tWord vt 'launch' 
lavatorie: nc;artifact count 'lavatory' 
lavishe: A;APP VNPPP con plusAmount up 'lavish' 
laz: vc;VI vi 'laze' 
leache: vc;VNPPP VPP VPPPP chgLooks 'leach' 
leapfrogg: vc;VNPPP VPP abstract count vt 'leapfrog' 
leas: vc;VNPPP VPP VerbNom count useC 'lease' 
leav: vc;VI VNPAP VNPNGoc VNPPPdir VNPRB VNPTOoc VPNGsc VPP component dative tWord vt vtoV 'leave' 
leche: vc;per v 'lech' 
lectur: vc;VNPPP VNPPhisNG VPP VPPPP VPhisNG VerbNom count 'lecture' 
leeche: vc;animal per v 'leech' 
legalis: vc;chgAttr vt 'legalise' 
legaliz: vc;chgAttr mkOwnKnowledge vt 'legalize' 
legislat: vc;VNPPP VPP VPhisNG create vt 'legislate' 
legitimatis: vc;chgAttr 'legitimatise' 
legitimatiz: vc;VHOWSS VhisNG chgAttr vt 'legitimatize' 
legitimis: vc;chgAttr 'legitimise' 
legitimiz: vc;chgAttr 'legitimize' 
lenifi: vc;chgEmo 'lenify' 
lenifie: vc;chgEmo 'lenify' 
leverag: vc;abstract vt 'leverage' 
levi: vc;VNPPP VerbNom artifact count vt 'levy' 
levie: vc;VNPPP VerbNom artifact count vt 'levy' 
levitat: vc;VI vt 'levitate' 
liais: vc;VPP persuade 'liaise' 
liberalis: vc;chgAttr vt 'liberalise' 
liberaliz: vc;chgAttr vt 'liberalize' 
liberat: vc;VNPPP mkAct vt 'liberate' 
librat: vc;enMove vt 'librate' 
licens: vc;VNPTOoc VerbNom VhisNG count dative tWord vt 'license' 
ligat: vc;resume vt 'ligate' 
lignifi: vc;chgAttr 'lignify' 
lignifie: vc;chgAttr 'lignify' 
lik: vc;VHOWSS VNG VNPAP VNPEN VNPPP VNPTOoc VPPforTO love passion vVing vt vtoV weakPI 'like' 
lin: vc;VNPPP abstract artifact count vacOf vt 'line' 
linearis: vc; 'linearise' 
liquefi: vc;chgAttr looksChg vt 'liquefy' 
liquefie: vc;chgAttr looksChg vt 'liquefy' 
liquidat: vc;enHidden mkBetter mkOwnKnowledge 'liquidate' 
liquidis: vc;looksChg 'liquidise' 
liquidiz: vc;chgAttr looksChg vt 'liquidize' 
liquifi: vc;looksChg 'liquify' 
liquifie: vc;looksChg 'liquify' 
litigat: vc;VPP VPPPP express 'litigate' 
lobb: vc;abstract count vt 'lob' 
lobbi: vc;VNPPP VNPTOoc VPP VPPforTO VPhisNG VerbNom artifact count per vtoV 'lobby' 
lobbie: vc;VNPPP VNPTOoc VPP VPPforTO VPhisNG VerbNom artifact count per vtoV 'lobby' 
localis: vc;chgAttr tWord vt 'localise' 
localiz: vc;VNPPP chgAttr mkOwnKnowledge tWord 'localize' 
locat: vc;VNPPP VNPRB VPP mkOwnKnowledge tWord vt 'locate' 
locomot: vc;chgLoc vt 'locomote' 
lodg: vc;VNPPP VPP component count group vt 'lodge' 
logg: vc;VPP artifact count natural vt 'log' 
lollopp: vc; 'lollop' 
lollygagg: vc; 'lollygag' 
lopp: A vc;VNPPP mkBetter 'lop' 
loung: vc;VI VPP artifact count vi 'lounge' 
lous: vc;animal 'louse' 
lubricat: vc;chgLooks vt 'lubricate' 
lugg: vc;VNPPPdir count vt 'lug' 
lullabie: nc;abstract count 'lullaby' 
lunche: vc;VI VPP vi 'lunch' 
lur: vc;VNPPPdir VNPTOoc VerbNom count ebla vt 'lure' 
luxat: vc;ill vt 'luxate' 
luxuriat: vc;VPP enDo vt 'luxuriate' 
lynche: vc;vt 'lynch' 
lys: vc; 'lyse' 
macerat: vc;VPP move vt 'macerate' 
machinat: vc;mkOwnKnowledge 'machinate' 
machine-washe: vc;clean hyphenated 'machine-wash' 
magnetis: vc;chgAttr vt 'magnetise' 
magnetiz: vc;chgAttr 'magnetize' 
magnifi: vc;VNPRB chgGood chgMeasure chgProperty moreC 'magnify' 
magnifie: vc;VNPRB chgGood chgMeasure chgProperty moreC 'magnify' 
mak: vc;VNG VNPAP VNPNP VNPPPfor VNPPhisNG abstract count dative tWord vt 'make' 
maladie: nc;phenomena socialMode 'malady' 
manacl: vc;artifact count vt 'manacle' 
manag: vc;correctW vtoV 'manage' 
mandat: vc;VTH VerbNom chg count natural vt 'mandate' 
manducat: vc;chgForm vt 'manducate' 
mangl: vc;count vt 'mangle' 
manicur: vc;VerbNom chg count vt 'manicure' 
manipulat: vc;VNPPP alive chg vt 'manipulate' 
manoeuvr: vc;VNPPP abstract count vt 'manoeuvre' 
manufactur: vc;VNPPP VNPPPas VerbNom artifact perOrgV vacOf 'manufacture' 
manumitt: vc;VNPPP mkAct vt 'manumit' 
mapp: vc;VNPPP count infosourceN vt 'map' 
marbleis: vc;vt 'marbleise' 
marbleiz: vc;vt 'marbleize' 
marcell: vc;chg 'marcel' 
marginalis: vc;chgAttr vt 'marginalise' 
marginaliz: vc;chgAttr vt 'marginalize' 
marinat: vc;VNPPP VPP vt 'marinate' 
marketiz: vc;VNPPP VNPPPas vt 'marketize' 
marrie: vc;VI VNPPP associate give perOrgV take vtPer 'marry' 
martyris: vc;end 'martyrise' 
martyriz: vc;end 'martyrize' 
marvell: vc;VPP abstract count 'marvel' 
masculinis: vc;vt 'masculinise' 
mashe: vc;VNPPP phy vt 'mash' 
mass-produc: vc;hyphenated vt 'mass-produce' 
massacr: vc;VerbNom count vt 'massacre' 
massag: vc;VerbNom count vt 'massage' 
masticat: vc;VNPPP chgForm 'masticate' 
masturbat: vc;associate 'masturbate' 
matche: vc;VIrecip VNPPP VPP artifact count 'match' 
materializ: vc;VPP end mkBetter 'materialize' 
matriculat: vc;per 'matriculate' 
matur: vc;AitPPforTOrs VI VNPPP VPP VPPas VPPhowTO pro situation up vt 'mature' 
maturat: vc;ill situation vt 'maturate' 
maximis: vc;moreC vt 'maximise' 
maximiz: vc;chgQuant mkAct moreC vt 'maximize' 
measur: vc;VNPPP VNPPPPP VNPPPas component count range tool vacOf vt 'measure' 
mechanis: vc;chgAttr vt 'mechanise' 
mechaniz: vc;chgAttr vt 'mechanize' 
meddl: vc;VI VPP aggravateW mkBad vi 'meddle' 
mediat: vc;VI VNPPP VPP persuade 'mediate' 
mediatiz: vc;take 'mediatize' 
medicat: vc;VNPPP resume vt 'medicate' 
meditat: vc;VI VPP tryToKnow vi 'meditate' 
melanis: vc; 'melanise' 
meliorat: vc;correctW mkBetter 'meliorate' 
melodie: nc;abstract count soundQua 'melody' 
melodiz: vc;produce 'melodize' 
memorializ: vc;VNPPPas pEmo vt 'memorialize' 
memorie: nc;abstract component ebla 'memory' 
memoriz: vc;haveKnowledge vt 'memorize' 
menac: vc;VI VNPPP VerbNom aggravateW count situation vt 'menace' 
menstruat: vc;VI metabolize vi 'menstruate' 
mensurat: vc;vt 'mensurate' 
merceris: vc;chgAttr 'mercerise' 
merceriz: vc;chgAttr 'mercerize' 
merchandiz: vc;prod v 'merchandize' 
mercurat: vc; 'mercurate' 
merg: vc;VIrecip VNPPP VPP VPPas perOrgV tie 'merge' 
meshe: vc;VIrecip VPP VPPas VRB component phy vt 'mesh' 
mesmeris: vc;improve 'mesmerise' 
mesmeriz: vc;VNPPP improve vt 'mesmerize' 
messag: vc;Nom VI VTH count 'message' 
messe: vc;VPP nt v 'mess' 
metaboliz: vc;enGrow 'metabolize' 
metamorphos: vc;VNPPP VNPPPas VPP VPPPP VPPas chgLooks looksChg vt 'metamorphose' 
metastasiz: vc;move nt 'metastasize' 
methodiz: vc;content 'methodize' 
metricat: vc;vt 'metricate' 
metricis: vc; 'metricise' 
microwav: vc;count phy 'microwave' 
micturat: vc;metabolize vt 'micturate' 
migrat: vc;VI VPP VPPPP VPPdir chgLoc 'migrate' 
militaris: vc;chg vt 'militarise' 
militariz: vc;chg vt 'militarize' 
militat: vc;VI VPP VPhisNG vi 'militate' 
mim: vc;count job vt 'mime' 
mimick: vc;VNPPPas VNPRB count vt 'mimic' 
minc: vc;VNPPP phy vt 'mince' 
mingl: vc;VNPPP VPP tie vt 'mingle' 
miniat: vc; 'miniate' 
miniaturis: vc;chgMeasure vt 'miniaturise' 
miniaturiz: vc;chgMeasure vt 'miniaturize' 
minifi: vc;chgMeasure lessC 'minify' 
minifie: vc;chgMeasure lessC 'minify' 
minimis: vc;lessC vt 'minimise' 
minimiz: vc;VNPPhisNG chgQuant lessC vt 'minimize' 
misallocat: vc; 'misallocate' 
misappli: vc;VNPPP mkAct vt 'misapply' 
misapplie: vc;VNPPP mkAct vt 'misapply' 
misappropriat: vc;VNPPP VNPPPas take vt 'misappropriate' 
misbehav: vc;VI nEmo vi 'misbehave' 
miscalculat: vc;VPP decide 'miscalculate' 
miscarri: vc;VI tWord troubleW 'miscarry' 
miscarrie: vc;VI tWord troubleW 'miscarry' 
miscegenat: vc;associate vt 'miscegenate' 
mischarg: vc; 'mischarge' 
misclassifi: vc; 'misclassify' 
misclassifie: vc; 'misclassify' 
misconceiv: vc;VNPPPas VNPTObe VTH cognition vt 'misconceive' 
misconstru: vc;VNPPP VNPPPas VNPTObe cognition vt 'misconstrue' 
miscreat: vc;vt 'miscreate' 
miscu: vc;nt v 'miscue' 
misdat: vc;VNPPPas vt 'misdate' 
misdiagnos: vc;check 'misdiagnose' 
misestimat: vc;decide vt 'misestimate' 
misfir: vc;VI abstract count nt vi 'misfire' 
misgaug: vc; 'misgauge' 
misgiv: vc;nAttitude 'misgive' 
misguid: vc;enDo vt 'misguide' 
mishandl: vc;vt 'mishandle' 
misjudg: vc;VNPPPas decide vt 'misjudge' 
mislabell: vc; 'mislabel' 
mismanag: vc;control vt 'mismanage' 
mismat: vc; 'mismate' 
misnam: vc;VNPPPas vt 'misname' 
misperceiv: vc; 'misperceive' 
misplac: vc;VNPPP vt 'misplace' 
mispric: vc; 'misprice' 
mispriz: vc;nAttitude nt 'misprize' 
mispronounc: vc;VNPPPas vt 'mispronounce' 
misquot: vc;VNPPNGoc abstract vt 'misquote' 
misrelat: vc; 'misrelate' 
misrout: vc; 'misroute' 
misrul: ;aggravateW nt v 'misrule' 
misse: vc;VHOWSS VNPNGoc VNPPP VPP VhisNG abstract passion possession tWord vVing vt 'miss' 
misstat: vc;mkMisunderstand vt 'misstate' 
mistak: vc;VNPPP VNPPPas aggravateW count nt vt 'mistake' 
misus: vc;VNPPP VNPPhisNG VerbNom troubleW vt 'misuse' 
mitigat: vc;causeNotDo chgProperty correctW vt 'mitigate' 
mitr: vc;count tool v 'mitre' 
mixe: vc;VI VIrecip VNPPP VPP VRB VerbNom vt 'mix' 
mizzl: vc;VI vi weatherChg 'mizzle' 
mobilis: vc;VNPPP VPP enDo vt 'mobilise' 
mobiliz: vc;VNPPP VPP enDo 'mobilize' 
moderat: A;VI VNPPP VPP count lessC per vt 'moderate' 
modernis: vc;chgAttr vt 'modernise' 
moderniz: vc;VI chgAttr vt 'modernize' 
modifi: vc;VNPPNGsc VNPPP VNPPPas VNPPhisNG VNPRB VNPTOoc VWHSS chg express resume tWord vt 'modify' 
modifie: vc;VNPPNGsc VNPPP VNPPPas VNPPhisNG VNPRB VNPTOoc VWHSS chg express resume tWord vt 'modify' 
modulariz: vc;chgAttr 'modularize' 
modulat: vc;VNPPP chg mkBetter vt 'modulate' 
moisturis: vc;chgMeasure 'moisturise' 
moisturiz: vc;pt 'moisturize' 
mollifi: vc;VNPRB chgEmo chgGood statePhy vt 'mollify' 
mollifie: vc;VNPRB chgEmo chgGood statePhy vt 'mollify' 
mollycoddl: vc;count vt 'mollycoddle' 
monopolis: vc;chg vt 'monopolise' 
monopoliz: vc;VNPPP chg possession 'monopolize' 
mooche: vc;VNPPP VPP per vt 'mooch' 
mopp: vc;VNPAP count currency prod tool vt 'mop' 
moralis: vc;VPP express vt 'moralise' 
moraliz: vc;VPP express vt 'moralize' 
mortgag: vc;VNPPP VerbNom artifact count vt 'mortgage' 
mortic: vc;count vt 'mortice' 
mortifi: vc;VNPPP phenomena vt 'mortify' 
mortifie: vc;VNPPP phenomena vt 'mortify' 
motivat: vc;VNPPP VNPPPas VNPPhisNG VNPTOoc chgEmo promoteW vt vtoV 'motivate' 
motorcycl: vc;count prod tool 'motorcycle' 
mottl: vc;VNPPP abstract vt 'mottle' 
mous: vc;VI 'mouse' 
mov: vc;VI VNPPP VNPPPPP VNPRB VNPTOoc VPP VPPPP VPPforTO VRB VTH VerbNom count thinking vt vtoV 'move' 
muckrak: vc; 'muckrake' 
muddl: vc;VIrecip VPP abstract vt 'muddle' 
muffl: vc;enHidden 'muffle' 
mulberrie: nc;component plant 'mulberry' 
multiplexe: vc;kind 'multiplex' 
multipli: vc;Math VI VNPPP VPP chgQuant create vt 'multiply' 
multiplie: vc;Math VI VNPPP VPP chgQuant create vt 'multiply' 
mummie: nc;component count per 'mummy' 
mummifi: vc;chgAttr 'mummify' 
mummifie: vc;chgAttr 'mummify' 
munche: vc;chgForm vt 'munch' 
mus: vc;VI VPP VTH abstract count 'muse' 
muscl: vc;VNPPPdir VNPRB bodyPart component count strength vt 'muscle' 
mushe: vc;artifact v 'mush' 
musse: vc;abstract vt 'muss' 
mussitat: vc;mkSound vt 'mussitate' 
mutat: vc;statePhy 'mutate' 
mutilat: vc;aggravateW mkBad resume vt 'mutilate' 
mutini: vc;VI VPP vi 'mutiny' 
mutinie: vc;VI VPP vi 'mutiny' 
muzzl: vc;artifact component count vt 'muzzle' 
mysterie: nc; 'mystery' 
mystifi: vc;VI annoy chgAttr chgKnow vtPer 'mystify' 
mystifie: vc;VI annoy chgAttr chgKnow vtPer 'mystify' 
mythicis: vc; 'mythicise' 
mythologis: vc;vt 'mythologise' 
nabb: vc;ceaseMove vt 'nab' 
nagg: vc;VPP VerbNom animal count per vt 'nag' 
name-dropp: vc;VI hyphenated vi 'name-drop' 
namedropp: vc; 'namedrop' 
narrat: vc;express vt 'narrate' 
nationalis: vc;chgAttr vt 'nationalise' 
nationaliz: vc;chgAttr vt 'nationalize' 
naturalis: vc;own vt 'naturalise' 
naturaliz: vc;own vt 'naturalize' 
nauseat: vc;injureW mkAct sufferFrom vtPer 'nauseate' 
navigat: vc;VNPPPdir VPPdir move vt 'navigate' 
necessitat: vc;VTH VhisNG tWord vt 'necessitate' 
necros: vc;phenomena 'necrose' 
needl: vc;VNPPP count prod tool vt 'needle' 
negat: vc;remove reply vt 'negate' 
negotiat: vc;VNPPP VPP VPPPP VhisNG communicate vt 'negotiate' 
nestl: vc;VNPPP abstract 'nestle' 
nettl: vc;VNPPP annoy vtPer 'nettle' 
neutralis: vc;causeNotDo mkBad vt 'neutralise' 
neutraliz: vc;causeNotDo mkBad vt 'neutralize' 
nibbl: vc;VPP abstract count vt 'nibble' 
nictat: vc;enMove vt 'nictate' 
nictitat: vc;enMove vt 'nictitate' 
nid-nodd: vc;enMove hyphenated 'nid-nod' 
nidifi: vc;create 'nidify' 
nidificat: vc; 'nidificate' 
nidifie: vc;create 'nidify' 
niggl: vc;VPP VPPPP communicate nEmo 'niggle' 
nigrifi: vc;chgAttr 'nigrify' 
nigrifie: vc;chgAttr 'nigrify' 
nipp: vc;VNPPP abstract count vt 'nip' 
nitrat: vc;artifact 'nitrate' 
nitrifi: vc;chgAttr vt 'nitrify' 
nitrifie: vc;chgAttr vt 'nitrify' 
nitrogenis: vc;chgAttr 'nitrogenise' 
nitrogeniz: vc;chgAttr 'nitrogenize' 
nixe: vc;quant v 'nix' 
nobbl: vc;take 'nobble' 
nodd: vc;VNPPP VPP VerbNom count 'nod' 
nominat: vc;VNPPP VNPPPas VNPTOoc enBe 'nominate' 
nonpluse: vc;noKnowledge vt 'nonplus' 
normalis: vc;chgAttr vt 'normalise' 
normaliz: vc;chgAttr 'normalize' 
nosediv: vc;VNPPP VPP count vt 'nosedive' 
noshe: vc;VI VPP vi 'nosh' 
notariz: vc;mkOwnKnowledge 'notarize' 
notat: vc;vt 'notate' 
notche: vc;VNPPP component count vt 'notch' 
notic: vc;VHOWSS VNPPP VNPTObe VSS VWHSS abstract count haveKnowledge tWord vVing vt 'notice' 
notifi: vc;VNPPP VNPSS express vt 'notify' 
notifie: vc;VNPPP VNPSS express vt 'notify' 
nourishe: vc;mkBetter mkOthersKnowledge promoteW vt 'nourish' 
novat: vc;vt 'novate' 
novelis: vc;chg vt 'novelise' 
noveliz: vc;chg vt 'novelize' 
nudg: vc;VNPPPdir abstract count vt 'nudge' 
nuk: vc;artifact v 'nuke' 
nullifi: vc;enHidden 'nullify' 
nullifie: vc;enHidden 'nullify' 
numerat: A vc;calculate vt 'numerate' 
nurtur: vc;VNPPP abstract promoteW vt 'nurture' 
nutat: vc;vt 'nutate' 
nutrifi: vc;vt 'nutrify' 
nutrifie: vc;vt 'nutrify' 
obfuscat: vc;mkAct vt 'obfuscate' 
objectifi: vc;enHidden 'objectify' 
objectifie: vc;enHidden 'objectify' 
objurgat: vc;annoy vt 'objurgate' 
oblig: vc;VNPPNGoc VNPTOoc enDo vt 'oblige' 
obligat: A vc;VNPPP VNPTOoc enDo 'obligate' 
obliterat: vc;chgInclude remove vt 'obliterate' 
obnubilat: vc;mkAct 'obnubilate' 
obscur: A;nt vt 'obscure' 
observ: vc;VHOWSS VI VNPNG VNPPP VNPPPas VNPTObe VTH chgFit pEmo perV sense vVing vt 'observe' 
obsesse: vc;VPP excite tWord vt 'obsess' 
obsolesc: vc;vt 'obsolesce' 
obsolet: A;looks nt v 'obsolete' 
obstipat: vc;vt 'obstipate' 
obturat: vc;openShut 'obturate' 
obviat: vc;enHidden remove 'obviate' 
occidentalis: vc; 'occidentalise' 
occlud: vc;chgProperty vt 'occlude' 
occupi: vc;VNPPP take timeOrSpace vt 'occupy' 
occupie: vc;VNPPP take timeOrSpace vt 'occupy' 
officialis: vc; 'officialise' 
officiat: vc;VPP VPPas act vt 'officiate' 
offsaddl: vc; 'offsaddle' 
offsett: nc vc;VBDN abstract vt 'offset' 
ogl: vc;mental vt 'ogle' 
omitt: vc;VTH chgInclude noKnowledge remove vt vtoV 'omit' 
ooz: vc;VNPPP VPPdir natural vt 'ooze' 
opacifi: vc;vt 'opacify' 
opacifie: vc;vt 'opacify' 
opalis: vc; 'opalise' 
operat: vc;VPP VPPas chgState control resume 'operate' 
opin: vc;VTH haveKnowledge 'opine' 
oppos: vc;VNPPP VNPPPas VhisNG disagree fight vt 'oppose' 
oppresse: vc;injureW mkBad vtPer 'oppress' 
optimis: vc;improve vt 'optimise' 
optimiz: vc;VNPPP VPP chgGood improve 'optimize' 
orat: vc;VNPPP VPP 'orate' 
orchestrat: vc;mkOwnKnowledge vt 'orchestrate' 
organis: vc;VNPPP VNPPPas create vt 'organise' 
organiz: vc;VNPPP VNPPPas create 'organize' 
orientalis: vc; 'orientalise' 
orientat: vc;VNPPP mkOwnKnowledge vt 'orientate' 
originat: vc;CR VPP VPPas statePhy tWord vt 'originate' 
oscillat: vc;VNPRB VPP statePhy 'oscillate' 
osculat: vc;vt 'osculate' 
osmos: vc;CR 'osmose' 
ossifi: vc;chgAttr 'ossify' 
ossifie: vc;chgAttr 'ossify' 
ostentat: vc;show vt 'ostentate' 
ostracis: vc;VNPPP chgInclude vt 'ostracise' 
ostraciz: vc;VNPPP chgInclude vt 'ostracize' 
outbalanc: vc; 'outbalance' 
outbidb: vc;VBDN VNPPP express vt 'outbid' 
outbrav: vc;vt 'outbrave' 
outcropp: vc;component count v 'outcrop' 
outdat: vc;looks 'outdate' 
outdistanc: vc;VNPPP vt 'outdistance' 
outfac: vc;vt 'outface' 
outfitt: vc;Nom VNPPP VNPPPas chg count pt tool vt vtoV 'outfit' 
outfli: vc; 'outfly' 
outflie: vc; 'outfly' 
outfoxe: vc;haveContest vt 'outfox' 
outlin: vc;VerbNom component count vt 'outline' 
outliv: vc;VNPPP vt 'outlive' 
outmarche: vc;vt 'outmarch' 
outmatche: vc;succeed vt 'outmatch' 
outmod: vc; 'outmode' 
outpac: vc;VNPPP vt 'outpace' 
outplai: vc;vt 'outplay' 
outplaie: vc;vt 'outplay' 
outputt: vc;abstract v vacFrom 'output' 
outrag: vc;VerbNom annoy emph passion vtPer 'outrage' 
outrang: vc;vt 'outrange' 
outrid: vc;chgTime vt 'outride' 
outrunn: vc;VNPPP succeed vt 'outrun' 
outscor: vc; 'outscore' 
outshin: vc;mkAct vt 'outshine' 
outslugg: vc; 'outslug' 
outsourc: vc; 'outsource' 
outspann: vc;enMove 'outspan' 
outstai: vc;vt 'outstay' 
outstaie: vc;vt 'outstay' 
outstretche: vc; 'outstretch' 
outstripp: vc;VNPPP succeed vt 'outstrip' 
outvi: vc;VNPPP vt 'outvie' 
outvot: vc;vt 'outvote' 
outwitt: vc;haveContest vt 'outwit' 
ovenbak: vc; 'ovenbake' 
overachiev: vc;vt 'overachieve' 
overanalys: vc; 'overanalyse' 
overanalyz: vc; 'overanalyze' 
overarche: vc;vt 'overarch' 
overaw: vc;vt 'overawe' 
overbidd: vc;VBDN VNPPP VPP abstract count express vt 'overbid' 
overcharg: vc;VNPNP VNPPP VerbNom troubleW vt 'overcharge' 
overcom: vc;remove vt 'overcome' 
overcommitt: vc; 'overcommit' 
overcompensat: vc;vt 'overcompensate' 
overcropp: vc;act vt 'overcrop' 
overcultivat: vc; 'overcultivate' 
overdresse: vc;cover vt 'overdress' 
overdriv: vc;abstract tool v 'overdrive' 
overemphasiz: vc;express vt 'overemphasize' 
overestimat: vc;nt troubleW vt 'overestimate' 
overexcit: vc; 'overexcite' 
overexpos: vc;vt 'overexpose' 
overfil: vc; 'overfile' 
overfli: vc;goThrough vt 'overfly' 
overflie: vc;goThrough vt 'overfly' 
overgorg: vc;metabolize 'overgorge' 
overgraz: vc; 'overgraze' 
overhyp: vc; 'overhype' 
overindulg: vc;VPP 'overindulge' 
overjoi: vc; 'overjoy' 
overjoie: vc; 'overjoy' 
overlapp: vc;VIrecip VPP abstract count timeOrSpace vt 'overlap' 
overli: vc;move vt 'overlie' 
overmedicat: vc; 'overmedicate' 
overplai: vc;vt 'overplay' 
overplaie: vc;vt 'overplay' 
overpopulat: vc;density vt 'overpopulate' 
overprais: vc;pEmo vt 'overpraise' 
overpric: vc; 'overprice' 
overproduc: vc;vt 'overproduce' 
overpurchas: vc; 'overpurchase' 
overrat: vc;VNPPPas vt 'overrate' 
overreache: vc;haveContest take vt 'overreach' 
overrefin: vc;vt 'overrefine' 
overregulat: vc; 'overregulate' 
overrid: vc;haveContest remove succeed vt 'override' 
overrul: vc;VhisNG disagree perOrgV remove vtPer 'overrule' 
overrunn: nc vc;VerbNom vt 'overrun' 
oversaturat: vc; 'oversaturate' 
overse: vc;VNPNGoc VhisNG check vt 'oversee' 
oversimplifi: vc;control vt 'oversimplify' 
oversimplifie: vc;control vt 'oversimplify' 
overspecialis: vc; 'overspecialise' 
overstai: vc;vt 'overstay' 
overstaie: vc;vt 'overstay' 
overstat: vc;VNPPP troubleW vt 'overstate' 
overstepp: vc;succeed vt 'overstep' 
overstresse: vc;express 'overstress' 
overstretche: vc; 'overstretch' 
oversubscrib: vc; 'oversubscribe' 
oversuppli: ;count troubleW v 'oversupply' 
oversupplie: ;count troubleW v 'oversupply' 
overtak: vc;goThrough succeed vt 'overtake' 
overtopp: vc;isa vt 'overtop' 
overus: vc;VNPPP VPP VerbNom 'overuse' 
overutilis: vc;vt 'overutilise' 
overutiliz: vc;vt 'overutilize' 
overvalu: A vc;VNPPP nt troubleW vt 'overvalue' 
overwrit: vc;express 'overwrite' 
ovulat: vc;metabolize vt 'ovulate' 
oxidat: vc;VNPPP chgAttr 'oxidate' 
oxidis: vc;VNPPP VPP chgAttr vt 'oxidise' 
oxidiz: vc;VNPPP VPP chgAttr 'oxidize' 
oxygenat: vc;chgAttr vt 'oxygenate' 
oxygenis: vc;chgAttr 'oxygenise' 
oxygeniz: vc;chgAttr vt 'oxygenize' 
pacifi: vc;chgEmo ebla mkBad vt 'pacify' 
pacifie: vc;chgEmo ebla mkBad vt 'pacify' 
padd: vc;VNPPP VPPdir artifact component count vt 'pad' 
paddl: vc;VNPPP VPPdir component count tool vt 'paddle' 
pag: vc;component count infosourceN quant vt 'page' 
paganis: vc; 'paganise' 
paginat: vc;enBe 'paginate' 
palisad: vc;count v 'palisade' 
palliat: vc;chgProperty correctW vt 'palliate' 
palpat: vc;check vt 'palpate' 
palpitat: vc;VI VPP move vi 'palpitate' 
pan-fri: vc;hyphenated 'pan-fry' 
pan-frie: vc;hyphenated 'pan-fry' 
panick: nc vc;VI VNPPNGoc VNPPP VerbNom annoy passion stateMental vt 'panic' 
pann: vc;VPP VRB count tool vt 'pan' 
parachut: vc;VPP count prod v 'parachute' 
parallell: A vc;VerbNom count vt 'parallel' 
paralys: vc;ill vt 'paralyse' 
paralyz: vc;vt 'paralyze' 
parche: vc;vt 'parch' 
pargett: vc;prod v 'parget' 
parodi: vc;VerbNom vt 'parody' 
parodie: vc;VerbNom vt 'parody' 
parri: vc;VNPPP abstract count vt 'parry' 
parrie: vc;VNPPP abstract count vt 'parry' 
partak: vc;VPP beNormal 'partake' 
parti: vc;count group v 'party' 
participat: vc;VI VPNGsc VPP VPPas act vi 'participate' 
particulariz: vc;express vt 'particularize' 
partie: vc;count group v 'party' 
passivat: vc; 'passivate' 
pasteuris: vc;mkBad vt 'pasteurise' 
pasteuriz: vc;mkBad vt 'pasteurize' 
pastrie: nc;artifact 'pastry' 
pastur: vc;count vt 'pasture' 
patche: vc;component count quant tool vt 'patch' 
patinat: vc; 'patinate' 
patroll: vc;VerbNom component count orgHN vt 'patrol' 
patroniz: vc;ceaseMove give vt 'patronize' 
patt: vc;VNPPP VPP abstract count vt 'pat' 
pauperiz: vc;chgAttr vt 'pauperize' 
paus: vc;VI VPP VerbNom act count statePhy timeUnit 'pause' 
pav: vc;enHidden 'pave' 
peculat: vc;VNPPP take vt 'peculate' 
pedall: vc;abstract component count prod tool vt 'pedal' 
peddl: vc;VNPPP VPP give mkSound send vt 'peddle' 
pedicur: vc;chg count 'pedicure' 
pee-pe: vc;hyphenated metabolize 'pee-pee' 
peev: vc;abstract vt 'peeve' 
pegg: vc;VNPPP VNPPPas artifact count vt 'peg' 
penaliz: vc;VNPPNGoc VNPPP mkBad vt 'penalize' 
penetrat: vc;CR VI VPP VRB chgForm haveKnowledge vt 'penetrate' 
pepp: vc;abstract v 'pep' 
peptis: vc;vt 'peptise' 
peptiz: vc;vt 'peptize' 
perambulat: vc;vt 'perambulate' 
perceiv: vc;VHOWSS VNPPNGoc VNPPP VNPPPas VNPTObe VNPasAP VSS feeling haveKnowledge perV vt 'perceive' 
perche: vc;VNPPP animal artifact 'perch' 
percolat: vc;VPP VRB chgLooks vt 'percolate' 
percusse: vc;chgForm vt 'percuss' 
peregrinat: vc;vt 'peregrinate' 
perennat: vc;vt 'perennate' 
perforat: vc;chg 'perforate' 
perfus: vc;moveDown 'perfuse' 
perishe: vc;VI end remove suffer vi 'perish' 
perjur: vc;mkOthersKnowledge vt 'perjure' 
permeat: vc;CR VPP move vt 'permeate' 
permitt: vc;VNPRB VNPTOoc VhisNG count dative pt vt 'permit' 
permut: vc;vt 'permute' 
perorat: vc;vt 'perorate' 
perpetrat: vc;VNPPP beBad vt 'perpetrate' 
perpetuat: vc;moreC vt 'perpetuate' 
perplexe: vc;aggravateW chgKnow mkAct noKnowledge vtPer 'perplex' 
persecut: vc;mkBad vt 'persecute' 
persever: vc;VI chgFit enGrow vi 'persevere' 
personalis: vc;chgAttr 'personalise' 
personaliz: vc;chgAttr vt 'personalize' 
personat: A vc;VhisNG chgAttr vt 'personate' 
personifi: vc;VNPPPas chgAttr vt 'personify' 
personifie: vc;VNPPPas chgAttr vt 'personify' 
perspir: vc;metabolize 'perspire' 
persuad: vc;VNPPP VNPRB VNPSS VNPTOoc perOrgV vtPer 'persuade' 
perus: vc;tryToKnow 'peruse' 
pervad: vc;appear move vt 'pervade' 
pervaporat: vc;vt 'pervaporate' 
pestl: vc;count tool vt 'pestle' 
petrifi: vc;VNPPP annoy chgAttr vt 'petrify' 
petrifie: vc;VNPPP annoy chgAttr vt 'petrify' 
pett: vc;animal count vt 'pet' 
pettifogg: vc;communicate 'pettifog' 
phagocytos: vc; 'phagocytose' 
phas: vc;VNPPP VPP component count situation timeUnit vt 'phase' 
phonat: vc;vt 'phonate' 
photocompos: vc; 'photocompose' 
photocopi: vc;VRB count vt 'photocopy' 
photocopie: vc;VRB count vt 'photocopy' 
photostatt: vc;count vt 'photostat' 
picnick: vc;VI count vi 'picnic' 
pictur: vc;VNPPP VRB VerbNom count scene vt 'picture' 
piddl: vc;VI VPP v waste 'piddle' 
piec: vc;VNPPP component count phy quant vt 'piece' 
pierc: vc;chgForm lessC move vt 'pierce' 
piffl: vc;VI vi 'piffle' 
pigeonhol: vc;abstract artifact count vt 'pigeonhole' 
pil: vc;VNPPP VPP component count phy quant 'pile' 
pillag: vc;abstract nt take vt 'pillage' 
pillori: vc;count v 'pillory' 
pillorie: vc;count v 'pillory' 
pinch-hitt: vc;VBDN chgForm hyphenated 'pinch-hit' 
pinkifi: vc; 'pinkify' 
pinkifie: vc; 'pinkify' 
pinn: vc;VNPPP artifact count 'pin' 
piqu: A vc;VNPPNGoc VNPPP a troubleW vt 'pique' 
pisse: vc;VI vi 'piss' 
pistol-whipp: vc;chgForm hyphenated 'pistol-whip' 
pitche: vc;Nom VNPRB VPP abstract artifact dative soundQua vt 'pitch' 
pitt: vc;VNPPP artifact component count group vt 'pit' 
plac: vc;VNPPPas VNPPPdir VNPRB VPP count vt 'place' 
placat: vc;chgEmo vt 'placate' 
plagiariz: vc;vt write 'plagiarize' 
plagu: vc;aggravateW curse vt 'plague' 
plann: vc;VHOWSS VI VNPPP VNPPPas VNPRB VNPTOoc VPP VPPNG VPPforTO VPhisNG VTH VWHSS VerbNom count infosourceN purpose thinking vacVTO vt vtoV 'plan' 
plashe: vc;count vt 'plash' 
plasmolys: vc; 'plasmolyse' 
plasmolyz: vc; 'plasmolyze' 
plasticis: vc;chgAttr 'plasticise' 
plasticiz: vc;chgAttr 'plasticize' 
plastinat: vc;vt 'plastinate' 
platt: vc;express 'plat' 
pledg: vc;abstract count vt vtoV 'pledge' 
plie: vc;VNPPP count quant vt 'ply' 
plodd: vc;VPPdir abstract move vt 'plod' 
plopp: vc;VNPPP VPP abstract count 'plop' 
plott: vc;VHOWSS VerbNom component count vt vtoV 'plot' 
plugg: vc;VPP VerbNom component count vt 'plug' 
plung: vc;VNPPP VPP VPPdir VRB VerbNom count lessC move nt 'plunge' 
poache: vc;ceaseMove vt 'poach' 
pok: vc;VNPPP VPP chg vt 'poke' 
polaris: vc;VPP chgAttr vt 'polarise' 
polariz: vc;VPP chgAttr 'polarize' 
polemiz: vc;communicate 'polemize' 
policie: nc;Nom VPP abstract info vacOf vtoV 'policy' 
polishe: vc;VerbNom improve origin up vt 'polish' 
politicis: vc;chgAttr 'politicise' 
politiciz: vc;chgAttr vt 'politicize' 
pollenat: vc;send vt 'pollenate' 
pollinat: vc;send vt 'pollinate' 
pollut: vc;troubleW vt 'pollute' 
polychromis: vc; 'polychromise' 
polymeris: vc;vt 'polymerise' 
pomad: vc;prod vt 'pomade' 
ponie: nc;animal 'pony' 
pontificat: vc;VI VTH abstract count vi 'pontificate' 
pooche: vc;animal v 'pooch' 
popp: A vc;VNPPPdir VNPRB VPP info vt 'pop' 
popularis: vc;chgAttr mkAct vt 'popularise' 
populariz: vc;chgAttr mkAct 'popularize' 
populat: vc;ceaseMove vt 'populate' 
pos: vc;VNPPP VPP VPPPP VPPas VRB abstract count posture vt 'pose' 
poshe: A vc;pt 'posh' 
positt: vc;VPP VTH VWHSS abstract vt 'posit' 
possesse: nc vc;VNPTOoc VPP Xs containV plu possession tWord vt 'possess' 
postpon: vc;VNG VNPPP chgMeasure vVing vt 'postpone' 
postpos: vc;vt 'postpose' 
postulat: vc;VTH VWHSS abstract count vt 'postulate' 
potentiat: vc;chgGood vt 'potentiate' 
pounc: vc;VI VPP abstract count mkBad 'pounce' 
powderis: vc; 'powderise' 
power-div: vc;VPPdir count hyphenated vt 'power-dive' 
practis: vc;VNG act solution study tWord vVing vacOf vacVO vacVTO vt 'practise' 
prais: vc;VNPPNGoc VNPPP VNPPPas VerbNom count good vt 'praise' 
pranc: vc;VPPdir abstract count vt 'prance' 
preache: vc;VPP chgProperty express perV vt 'preach' 
preachifi: vc;express vi 'preachify' 
preachifie: vc;express vi 'preachify' 
preapprov: vc; 'preapprove' 
prearrang: vc;VPPforTO vt vtoV 'prearrange' 
preassembl: vc; 'preassemble' 
precalculat: vc; 'precalculate' 
precipitat: vc;VI VNPPP VPP causeV chgConnect move vt 'precipitate' 
preclud: vc;VNG VNPPNG causeNotDo remove vt 'preclude' 
preconceiv: vc;vt 'preconceive' 
preconiz: vc;express 'preconize' 
predat: vc;statePhy vt 'predate' 
predefin: vc; 'predefine' 
predestin: vc;VNPTOoc VTH vt 'predestine' 
predetermin: vc;VNPTOoc VTH VWHSS decide vt 'predetermine' 
predispos: vc;VNPPP VNPTOoc volition 'predispose' 
predominat: vc;VPP chg 'predominate' 
prefabricat: vc;create vt 'prefabricate' 
preferr: vc;VNPAP VNPPP VNPPhisNG VNPTO VPPforTO VTH VhisNG expression love passion vVing volition vt vtoV weakPI 'prefer' 
prefigur: vc;beC vt 'prefigure' 
pregnancie: nc;statePhy time 'pregnancy' 
preincubat: vc; 'preincubate' 
prejudg: vc;VHOWSS VWHSS vt 'prejudge' 
prejudic: vc;VNPPP VerbNom aggravateW thinking vt 'prejudice' 
premeditat: vc;VNG mkOwnKnowledge vt 'premeditate' 
premisse: vc;count v 'premiss' 
preoccupi: vc;VNPPP behavior vt 'preoccupy' 
preoccupie: vc;VNPPP behavior vt 'preoccupy' 
prepackag: vc; 'prepackage' 
prepar: vc;VNPPNGoc VNPPPfor VNPPhisNG VNPTOoc VPP VPPforTO act produce vt vtoV 'prepare' 
prepos: vc; 'prepose' 
prepossesse: vc;VNPTOoc mkOthersKnowledge vt 'prepossess' 
preprocesse: vc;control 'preprocess' 
preprogramm: vc;VNPAP vt 'prerecord' 
presag: vc;VPP abstract count linkV vt 'presage' 
prescrib: vc;VHOWSS VNPPPas VNPPPfor VNPTOoc VPPforTO VTH VhisNG chgProperty express pt useC vt vtoV 'prescribe' 
preserv: vc;count vt 'preserve' 
presid: vc;VPP control vt 'preside' 
presignifi: vc;express 'presignify' 
presignifie: vc;express 'presignify' 
presse: vc;VNPPPdir VNPTOoc VPP VPPforTO comHN count strength vt vtoV 'press' 
pressur: vc;VNPPP VNPPhisNG VNPTOoc abstract ntN situation strength vt 'pressure' 
pressuris: vc; 'pressurise' 
presum: vc;VNPAP VNPTOoc VSS VTH deduce enBe volition vtoV 'presume' 
presuppos: vc;VTH beC vt 'presuppose' 
pretermitt: vc;nAttitude vt 'pretermit' 
prettifi: vc;chgGood chgLooks vt 'prettify' 
prettifie: vc;chgGood chgLooks vt 'prettify' 
prevaricat: vc;VI mkSound vi 'prevaricate' 
previs: vc;haveKnowledge vt 'previse' 
pri: vc;VPP VRB tryToKnow 'pry' 
pric: vc;VNPRB VRB price vt 'price' 
prickl: vc;count vt 'prickle' 
prie: vc;VPP VRB tryToKnow 'pry' 
prigg: vc;count per v 'prig' 
privatis: vc;chgAttr vt 'privatise' 
privatiz: vc;chgAttr 'privatize' 
prob: vc;VNPPP VPP VerbNom component count tWord tool vt 'probe' 
problematiz: vc;worsen 'problematize' 
processe: vc;Nom VNPPP VPP VPPforTO count solution tWord vacFor vacOf vacVTO vt vtoV 'process' 
procrastinat: vc;VPP chgMeasure 'procrastinate' 
procreat: vc;create 'procreate' 
procur: vc;VNPPP VNPTOoc own take vt 'procure' 
prodd: vc;VNPPNGoc VNPPP VNPTOoc abstract count vt 'prod' 
produc: vc;VI VNPPP VNPTOoc causeV tWord vt 'produce' 
profan: A;nt vt 'profane' 
professe: vc;VNPPP VTH enBe express vtoV 'profess' 
professionalis: vc;content vt 'professionalise' 
professionaliz: vc;content vt 'professionalize' 
prognosticat: vc;VTH beC 'prognosticate' 
programm: vc;Nom VNPTOoc VPP count thinking vt vtoV 'programme' 
prolaps: vc;v 'prolapse' 
proliferat: vc;VPP create moreC move 'proliferate' 
promis: vc;VI VNPSS VNPTOsc VSS VTH VerbNom dative prospect tWord vt vtoV 'promise' 
promot: vc;VNPPP VNPPPPP VNPPPas VNPTObe VhisNG give move perOrgV promoteW vt 'promote' 
promulgat: vc;express vt 'promulgate' 
pronat: vc;vt 'pronate' 
pronounc: vc;VNPAP VNPEN VNPTObe VPP VSS VTH express perOrgV vt 'pronounce' 
propagandiz: vc;express vt 'propagandize' 
propagat: vc;VPP create express 'propagate' 
propell: vc;VNPPPdir VNPTOoc enDo vt 'propel' 
prophesi: vc;VSS deduce express vt 'prophesy' 
prophesie: vc;VSS deduce express vt 'prophesy' 
propitiat: vc;persuade 'propitiate' 
propos: vc;VNPPP VNPPPas VPP VPPTH VPPforTO VTH VWHSS VhisNG express perOrgV vtoV 'propose' 
propp: vc;VNPPP artifact component count 'prop' 
prorat: vc;vt 'prorate' 
prorogu: vc;chgMeasure vt 'prorogue' 
proscrib: vc;VNPPNGoc VNPPP causeNotDo vt 'proscribe' 
prosecut: vc;VNPPNGoc VNPPP VNPPPas act attack express vt 'prosecute' 
proselyt: vc;count per v 'proselyte' 
prostitut: vc;VNPPP aggravateW con2 count job vt 'prostitute' 
protonat: vc; 'protonate' 
protrud: vc;VI VPP VPPdir enMove looksChg 'protrude' 
protuberat: vc;vt 'protuberate' 
prov: vc;VHOWSS VNPAP VNPNP VNPPP VNPPPas VNPTObe VPP VRB VSS VWHSS mkOwnKnowledge tWord vAP vt vtoV 'prove' 
provid: vc;VNPPNGsc VNPPPas VPP VPPforTO VPhisNG causeV dative pt vacVO vt vtoV 'provide' 
provok: vc;VNPPNGoc VNPPP VNPTOoc chgEmo mkBad vt 'provoke' 
prun: vc;VNPPP mkBetter remove vt 'prune' 
psychoanalys: vc;vt 'psychoanalyse' 
psychoanalyz: vc;vt 'psychoanalyze' 
publiciz: vc;express perOrgV vt 'publicize' 
publishe: vc;VNPPP VNPPPas express perOrgV 'publish' 
pugg: vc;count v 'pug' 
puk: ;VI count nt per v 'puke' 
pullulat: vc;create vt 'pullulate' 
puls: vc;VPP count vt 'pulse' 
pulsat: vc;VI move vi 'pulsate' 
pulveris: vc;chgForm vt 'pulverise' 
pulveriz: vc;chgForm looksChg vt 'pulverize' 
pumic: vc;natural v 'pumice' 
pummell: vc;VI chgForm 'pummel' 
punche: vc;VNPPP VNPRB VRB VerbNom artifact vt 'punch' 
punctuat: vc;express vt 'punctuate' 
punctur: vc;abstract count space vt 'puncture' 
punishe: vc;VNPPNGoc VNPPP attack mkBad vtPer 'punish' 
pupat: vc;beC 'pupate' 
puppie: nc;animal 'puppy' 
purchas: vc;VNPPPPP VNPPPfor VerbNom count perOrgV useC vt 'purchase' 
purg: vc;VNPPP VerbNom count nt vt 'purge' 
purifi: vc;VNPPP chgProperty improve vt 'purify' 
purifie: vc;VNPPP chgProperty improve vt 'purify' 
purpurat: vc; 'purpurate' 
purs: vc;artifact count vt 'purse' 
pursu: vc;VNPPPdir mkBad take 'pursue' 
pushe: vc;VNPAP VNPPPdir VNPRB VNPTOoc VPP VPPforTO VRB VerbNom count strength vt vtoV 'push' 
pussie: nc;animal count 'pussy' 
putrefi: vc;mkAct vt 'putrefy' 
putrefie: vc;mkAct vt 'putrefy' 
quadrat: vc;abstract v 'quadrate' 
quadrupl: A nc vc;abstract count 'quadruple' 
quadruplicat: A vc;a count vt 'quadruplicate' 
quak: vc;VI VPP count phenomena vi 'quake' 
qualifi: vc;VNPPP VNPPPas VNPTOoc VPP VPPas express standard vtoV 'qualify' 
qualifie: vc;VNPPP VNPPPas VNPTOoc VPP VPPas express standard vtoV 'qualify' 
quantifi: vc;chgAttr vt 'quantify' 
quantifie: vc;chgAttr vt 'quantify' 
quantitat: vc; 'quantitate' 
quarantin: vc;VerbNom nt vt 'quarantine' 
quarrell: vc;VI VIrecip VPP VPPPP VPhisNG VerbNom count 'quarrel' 
quarrie: nc;VNPPP VPP artifact count vt 'quarry' 
quashe: vc;enHidden haveContest remove 'quash' 
quenche: vc;chgMeasure statePhy vt 'quench' 
queri: vc;VNPPP VNPPhisNG VPP VerbNom count vt 'query' 
querie: vc;VNPPP VNPPhisNG VPP VerbNom count vt 'query' 
queu: vc;VI VerbNom count phy v 'queue' 
quibbl: vc;VIrecip VPP VPPNG VPhisNG VTH abstract communicate count 'quibble' 
quick-freez: vc;chgMeasure hyphenated vt 'quick-freeze' 
quick-fri: vc;hyphenated produce 'quick-fry' 
quick-frie: vc;hyphenated produce 'quick-fry' 
quiesc: vc; 'quiesce' 
quintupl: vc;RB quant 'quintuple' 
quitt: vc;VNG VNPPPas VPP VPPas chgInclude obey perOrgV remove vt 'quit' 
quizz: vc;VNPPP VNPPhisNG count vt 'quiz' 
quot: vc;VNPNGoc VNPPNGoc VNPPP VNPPPas VPP VerbNom component count dative vt 'quote' 
rac: vc;VNPPPdir VPP VPPPP VPPPPdir VPPdir VerbNom group 'race' 
radiat: vc;VPP chgLooks send 'radiate' 
radiolocat: vc;vt 'radiolocate' 
raffl: vc;abstract count vt 'raffle' 
rais: vc;VI VNPAP VNPPP VNPPPas VNPRB VNPTOoc VPP VerbNom count moreC vt 'raise' 
rak: vc;VPP count tool vt 'rake' 
ralli: vc;VI VNPPP VNPTOoc VPP VPPPP VerbNom count improve prod0 vt vtoV 'rally' 
rallie: vc;VI VNPPP VNPTOoc VPP VPPPP VerbNom count improve prod0 vt vtoV 'rally' 
rambl: vc;VI VPPdir abstract count vi 'ramble' 
ramifi: vc;VPP beC looksChg 'ramify' 
ramifie: vc;VPP beC looksChg 'ramify' 
ramm: vc;VIrecip VNPPP VPP animal count vt 'ram' 
rampag: vc;VI VPP VPPdir VerbNom count nt vi 'rampage' 
randomis: vc;chgAttr vt 'randomise' 
randomiz: vc;chgAttr vt 'randomize' 
rankl: vc;vt 'rankle' 
rappell: vc;abstract v 'rappel' 
rarefi: vc;chgAttr concentration vt 'rarefy' 
rarefie: vc;chgAttr concentration vt 'rarefy' 
rarifi: vc;chgGood 'rarify' 
rarifie: vc;chgGood 'rarify' 
ras: vc;chgLooks 'rase' 
ratifi: vc;VNPPP pEmo tWord vt 'ratify' 
ratifie: vc;VNPPP pEmo tWord vt 'ratify' 
ratiocinat: vc;think vt 'ratiocinate' 
rationalis: vc;VNG VNPPP VNPPPas VNPPhisNG VTH chgAttr vt 'rationalise' 
rationaliz: vc;VNG VNPPP VNPPPas VNPPhisNG VTH chgAttr vt 'rationalize' 
rattl: vc;count nt 'rattle' 
rav: A vc;VI VPP VPPPP VTH a count vi 'rave' 
ravag: vc;VerbNom attack nt 'ravage' 
ravell: vc;separate vt 'ravel' 
ravishe: vc;VNPPP take vt 'ravish' 
raz: vc;VNPPP chgLooks vt 'raze' 
re-estimat: vc;hyphenated mkOwnKnowledge 're-estimate' 
re-purpos: vc;hyphenated store 're-purpose' 
re-tak: vc;hyphenated tryToKnow 're-take' 
reaccelerat: vc; 'reaccelerate' 
reache: vc;VPP VPPPP VPPdir VRB VerbNom count vacOf vacTo vt 'reach' 
reacquir: vc; 'reacquire' 
reactivat: vc;vt 'reactivate' 
readi: A;APP ATO abstract count pred v 'ready' 
readie: A;APP ATO abstract count pred v 'ready' 
readmitt: vc;VNPPP VNPPhisNG vt 'readmit' 
realin: vc; 'realine' 
reallocat: vc;vt 'reallocate' 
reallott: vc;vt 'reallot' 
reanimat: vc;chgState vt 'reanimate' 
rearrang: vc;VNPPP control mkBetter produce vt 'rearrange' 
reassembl: vc;VNPPPas vt 'reassemble' 
reassum: vc; 'reassume' 
reassur: vc;VNPPP VNPSS vt 'reassure' 
reattache: vc; 'reattach' 
reattribut: vc;VNPPP VNPPhisNG vt 'reattribute' 
reav: vc;collect 'reave' 
rebalanc: vc; 'rebalance' 
rebell: vc;VPP VerbNom count per vi 'rebel' 
rebuk: vc;VNPPNGoc VNPPP abstract count nAttitude nt perV vtPer 'rebuke' 
reburi: vc;vt 'rebury' 
reburie: vc;vt 'rebury' 
rebutt: vc;VNPPP reply 'rebut' 
recalculat: vc;VNPPP VNPPPas VNPTOoc VPNGsc VPP VTH vt 'recalculate' 
recapitulat: vc;VI vt 'recapitulate' 
recapp: vc;VNPPP abstract count vt 'recap' 
recaptur: vc;VNPPPas abstract vt 'recapture' 
reced: vc;VI VPP VPPPP move 'recede' 
receiv: vc;VNPPP VNPPPas tWord vt 'receive' 
recidivat: vc;vt 'recidivate' 
reciprocat: vc;VI VPNGsc VPP express give move 'reciprocate' 
recit: vc;VNPAP VNPPPas dative mkSound vt 'recite' 
reclassifi: vc;chgInclude 'reclassify' 
reclassifie: vc;chgInclude 'reclassify' 
reclin: vc;VPP move vt 'recline' 
recognis: vc;know tWord tryToKnow 'recognise' 
recogniz: vc;VHOWSS VNPPP VNPPPas VTH express haveKnowledge pt tryToKnow vt 'recognize' 
recombin: vc;VNPPP VPP 'recombine' 
recommenc: vc;vt 'recommence' 
recommitt: vc;VNPPP VNPPhisNG act vt 'recommit' 
recompens: vc;VNPPP abstract artifact vt 'recompense' 
recompos: vc; 'recompose' 
reconcil: vc;VI VIrecip VNPPP VPP VPPTH associate persuade 'reconcile' 
recondens: vc; 'recondense' 
reconnoitr: vc;check 'reconnoitre' 
reconsecrat: vc;VNPPPas vt 'reconsecrate' 
reconstitut: vc;create 'reconstitute' 
reconven: vc; 'reconvene' 
recopi: vc;create 'recopy' 
recopie: vc;create 'recopy' 
recreat: vc;VNPPP VNPPPas 'recreate' 
recriminat: vc;VPP VTH express 'recriminate' 
recrudesc: vc;beBad vt 'recrudesce' 
rectifi: vc;VI VNPPP correctW resume vt 'rectify' 
rectifie: vc;VI VNPPP correctW resume vt 'rectify' 
recuperat: vc;VI VPNGsc VPP cease keep statePhy 'recuperate' 
recurr: vc;VI appear beBad vi 'recur' 
recurv: vc;move vt 'recurve' 
recus: vc;chgFit vt 'recuse' 
recycl: vc;VNPPP VNPPPas VPPas chg 'recycle' 
redecorat: vc;VNPPP VNPPPas vt 'redecorate' 
redefin: vc;VHOWSS VNPPP VNPPPas VWHSS vt 'redefine' 
redeploi: vc;VNPPP 'redeploy' 
redeploie: vc;VNPPP 'redeploy' 
redistribut: vc;VNPPP vt 'redistribute' 
redoubl: vc;chgQuant quantChg vt 'redouble' 
redresse: vc;VPP abstract artifact vt 'redress' 
reduc: vc;VI VNPPNGsc VNPPP VPP VRB lessC vt 'reduce' 
reduplicat: vc;freq 'reduplicate' 
reemerg: vc; 'reemerge' 
reestablishe: vc;create 'reestablish' 
reevaluat: vc; 'reevaluate' 
reexamin: vc;VHOWSS VWHSS tryToKnow vt 'reexamine' 
refere: vc;count job vt 'referee' 
referr: vc;VNPPP VNPPPas VPP VPPPP connective linkV tryToKnow vt 'refer' 
refin: vc;VNPPP demeanor vt 'refine' 
refinanc: vc;VNPPP VPP 'refinance' 
refitt: vc;VNPPP abstract count vt 'refit' 
reflat: vc;VNPPP 'reflate' 
reforg: vc; 'reforge' 
reformulat: vc;VNPPP VPP 'reformulate' 
refractur: vc; 'refracture' 
refreshe: vc;VNPPP chgIsa cleanse improve vt 'refresh' 
refrigerat: vc;enMove vt 'refrigerate' 
refurbishe: vc;VNPPP VNPRB improve resume vt 'refurbish' 
refus: vc;VI dative nt remove vt vtoV waste 'refuse' 
refut: vc;VTH annoy reply vt 'refute' 
regenerat: vc;VNPPP chgGood statePhy 'regenerate' 
registrat: vc; 'registrate' 
regorg: vc;moveOut 'regorge' 
regresse: vc;VNPPP VPP VRB abstract 'regress' 
regrett: vc;VHOWSS VTH VWHSS VerbNom VhisNG hate nt passion vVing vt vtoV weakPI 'regret' 
regularis: vc;chgAttr vt 'regularise' 
regulariz: vc;chgAttr 'regularize' 
regulat: vc;VNPPP VWHSS VhisNG chgAttr mkBetter vt 'regulate' 
regurgitat: vc;VPP move moveOut vt 'regurgitate' 
rehabilitat: vc;VNPPPas chgGood 'rehabilitate' 
rehous: vc;VNPPP vt 'rehouse' 
reifi: vc;chgAttr vt 'reify' 
reifie: vc;chgAttr vt 'reify' 
reignit: vc;warmUp 'reignite' 
reimburs: vc;VNPNP VNPPP give vt 'reimburse' 
reincarcerat: vc; 'reincarcerate' 
reincarnat: A vc;VNPPPas VPPas exist vt 'reincarnate' 
reincorporat: vc; 'reincorporate' 
reinforc: vc;VNPPP chgProperty chgQuant enGrow promoteW 'reinforce' 
reinstat: vc;VNPPP VNPPPas chgGood use vt 'reinstate' 
reinstitut: vc; 'reinstitute' 
reintegrat: vc;VNPPP VNPPPas VPP 'reintegrate' 
reintroduc: vc;VNPPP vt 'reintroduce' 
reissu: vc;VNPPP count vt 'reissue' 
reiterat: vc;VNPPP VTH act express vt 'reiterate' 
rejoic: vc;VI VPP comfortW vi 'rejoice' 
rejuvenat: vc;chgGood improve statePhy vt 'rejuvenate' 
rekindl: vc;VNPPP vt warmUp 'rekindle' 
relaps: vc;VI VPP beBad vi 'relapse' 
relat: vc;VHOWSS VI VNPPP VPP VTH connective express vt 'relate' 
relaunche: vc; 'relaunch' 
relaxe: vc;VPP pred pt 'relax' 
releas: vc;VNPPNGoc VNPPP VNPRB VNPTOoc VWHSS VerbNom count perOrgV tWord vt 'release' 
relegat: vc;VNPPP chgGrade chgLoc vt 'relegate' 
reli: vc;VI VPP VPPPP VPhisNG relate tWord vi 'rely' 
relie: vc;VI VPP VPPPP VPhisNG relate tWord vi 'rely' 
reliev: vc;VNPPP correctW vt 'relieve' 
relin: vc;VNPPP vt 'reline' 
relinquishe: vc;VNPPP give vt 'relinquish' 
relishe: vc;VNG VerbNom content taste vt 'relish' 
reliv: vc;VHOWSS VNG VNPPP vt 'relive' 
relocat: vc;VNPPP VPP mkOwnKnowledge 'relocate' 
remak: vc;VNPPP VNPPPas VNPPhisNG count vt 'remake' 
remarri: vc;VPP VRB associate give 'remarry' 
remarrie: vc;VPP VRB associate give 'remarry' 
remedi: vc;VNPPP VerbNom artifact correctW count solution vt 'remedy' 
remediat: vc;vt 'remediate' 
remedie: vc;VNPPP VerbNom artifact correctW count solution vt 'remedy' 
remilitaris: vc;vt 'remilitarise' 
reminisc: vc;VI VPP VPPPP think vi 'reminisce' 
remitt: vc;VNPPP abstract vt 'remit' 
remodell: vc;VNPPPas improve vt 'remodel' 
remonstrat: vc;VI VPP VPPPP annoy 'remonstrate' 
remov: vc;VNPPP VNPPPPP VNPPPas remove vt 'remove' 
remunerat: vc;VNPPP give help vtPer 'remunerate' 
renam: vc;VNPNP VNPPP VNPPPas chgAttr vt 'rename' 
reneg: vc;VI VPNGsc VPP abstract 'renege' 
renegociat: vc; 'renegociate' 
renegotiat: vc;VIrecip VNPPP VPP VPPPP 'renegotiate' 
renormalis: vc; 'renormalise' 
renounc: vc;VNPPPas VhisNG chgConnect give nEmo vt 'renounce' 
renovat: vc;VNPPP beautify resume vt 'renovate' 
reorganis: vc;create vt 'reorganise' 
reorganiz: vc;VNPPP VPP VPPas create 'reorganize' 
repackag: vc;VNPPPas cover vt 'repackage' 
repatriat: vc;VNPPP count per vt 'repatriate' 
repell: vc;VNPPP attack chgInclude disagree send vt 'repel' 
rephras: vc;mkSound 'rephrase' 
repin: vc;VI VPP nEmo nt vi 'repine' 
replac: vc;VNPPP VNPPPas chgInclude chgIsa tWord vt 'replace' 
replenishe: vc;VNPPP improve vt 'replenish' 
repli: vc;VI VPP VTH VerbNom count perOrgV 'reply' 
replicat: A vc;create vt 'replicate' 
replie: vc;VI VPP VTH VerbNom count perOrgV 'reply' 
repott: vc;VNPPP provideFor vt 'repot' 
represse: vc;VNPPP haveContest remove vt 'repress' 
repric: vc; 'reprice' 
repris: vc;whileAway 'reprise' 
reproache: vc;VNPPP VNPPhisNG abstract blame nt vtPer 'reproach' 
reprocesse: vc;VNPPP VNPPPas chg vt 'reprocess' 
reproduc: vc;VNPPP VNPPPas VPPas appear create express vt 'reproduce' 
reprov: vc;VNPPNGoc VNPPP annoy blame vt 'reprove' 
republishe: vc;express vt 'republish' 
repudiat: vc;VNPPPas mkOwnKnowledge remove reply vt 'repudiate' 
repuls: vc;VNPPP abstract vt 'repulse' 
repurchas: vc;VNPPP VerbNom pt useC vt 'repurchase' 
reput: vc;VNPEN VNPTObe abstract count reputation vt 'repute' 
requir: vc;VNPEN VNPPP VNPPPas VNPTOoc VPPTH VTH VhisNG need volition vt 'require' 
requit: vc;VNPPP give mkBad vt 'requite' 
rerout: vc;chg 'reroute' 
rerunn: nc vc;VNPPP VNPPPas VPPas VerbNom count 'rerun' 
rescal: vc; 'rescale' 
reschedul: vc;VNPPP VPP VhisNG vt 'reschedule' 
rescu: vc;VNPPP VerbNom count pt up vt 'rescue' 
researche: vc;VNPPPas VNPRB VerbNom infoV infosourceN onV tWord vacP vt 'research' 
resembl: vc;beSame vt 'resemble' 
reserv: vc;VNPPP VNPPPas VNPPhisNG VPP abstract artifact vt 'reserve' 
resett: vc;VBDN VNPPP mkBetter vt 'reset' 
resettl: vc;VHOWSS VI VNPPP VPP VWHSS control vt 'resettle' 
reshap: vc;VNPPP VNPPPas vt 'reshape' 
reshuffl: vc;VerbNom count 'reshuffle' 
resil: vc;move vt 'resile' 
resiz: vc; 'resize' 
resolv: vc;VHOWSS VNPPP VNPPhisNG VNPRB VTH VWHSS correctW mental vt vtoV 'resolve' 
resonat: vc;VI VPP act express 'resonate' 
respir: vc;VI metabolize 'respire' 
restag: vc; 'restage' 
restat: vc;VHOWSS VNPPP VNPPPas VTH VWHSS express vt 'restate' 
restitut: vc;VNPPP statePhy vt 'restitute' 
restor: vc;VNPPP VNPPPas VRB chgGood improve statePhy take vt 'restore' 
restructur: vc;VNPPP VNPPPas VPP VPPPP VPPas create 'restructure' 
restudi: nc vc;tryToKnow 'restudy' 
restudie: nc vc;tryToKnow 'restudy' 
restyl: vc;VNPPPas vt 'restyle' 
resum: vc;VNG VPNGsc VPP count 'resume' 
resuppli: vc;VNPPP count vt 'resupply' 
resupplie: vc;VNPPP count vt 'resupply' 
resurfac: vc;VNPPP vt 'resurface' 
resurg: vc;statePhy vt 'resurge' 
resuscitat: vc;beRecovered 'resuscitate' 
retak: vc;VNPPP VNPPPas abstract count vt 'retake' 
retaliat: vc;VI VPP mkBad 'retaliate' 
retche: vc;VI VPP abstract nt vi 'retch' 
reti: vc; 'retie' 
retir: vc;VNPPNGoc VNPPP VNPPPas VPNGsc VPP VPPPP VPPas act 'retire' 
retouche: vc;VNPPP act resume vt 'retouch' 
retrac: vc;VNPPP move vt 'retrace' 
retranslat: vc;express 'retranslate' 
retransmitt: vc;VNPPP VNPPPas VRB express vt 'retransmit' 
retrenche: vc;VNPPP VPP chgMeasure chgQuant 'retrench' 
retri: vc;act ask vt 'retry' 
retrie: vc;act ask vt 'retry' 
retriev: vc;VNPPP take think vt 'retrieve' 
retroced: vc;move 'retrocede' 
retrofitt: vc;resume 'retrofit' 
retrogresse: vc;VI VPP VPPas quality statePhy vi 'retrogress' 
rett: vc;VNPPP moveIn vt 'ret' 
reunifi: vc;VNPPP VNPPPas tie 'reunify' 
reunifie: vc;VNPPP VNPPPas tie 'reunify' 
reunit: vc;VIrecip VPP VPPas associate 'reunite' 
reus: vc;tWord v vacOf 'reuse' 
revalu: vc;VNPPP VNPPPas quantChg vt 'revalue' 
revell: vc;VI VPP VerbNom stateMental vi 'revel' 
rever: vc;VNPPP VNPPPas pAttitude vt 'revere' 
reverberat: vc;VPP act express 'reverberate' 
revett: vc;enHidden 'revet' 
revis: vc;VNPPP VNPPPPP abstract count mkBetter resume vt 'revise' 
revitaliz: vc;chgGood improve statePhy vt 'revitalize' 
reviv: vc;VPP chgGood statePhy 'revive' 
revivifi: vc;chgGood statePhy vt 'revivify' 
revivifie: vc;chgGood statePhy vt 'revivify' 
revok: vc;VNPPP abstract count enHidden remove 'revoke' 
revolutionis: vc;improve 'revolutionise' 
revolutioniz: vc;VNPPP VNPPPas VNPPhisNG chgAttr improve vt 'revolutionize' 
revolv: vc;VPP VPhisNG goRound move 'revolve' 
revv: vc;count quant vt 'rev' 
reweav: vc; 'reweave' 
rewir: vc;vt 'rewire' 
rewrit: vc;VNPPP VNPPPas VerbNom count 'rewrite' 
rhym: vc;VNPPP VPP natural thinking 'rhyme' 
ridd: vc;VBDN VNPPP separate vt 'rid' 
ridicul: vc;VNPPP VNPPPas VerbNom nt vt 'ridicule' 
riffl: vc;VPP abstract natural vt 'riffle' 
rigg: vc;VNPPP VNPPPas VNPTOoc artifact count vt 'rig' 
rigidifi: vc;chgAttr vt 'rigidify' 
rigidifie: vc;chgAttr vt 'rigidify' 
ril: vc;VNPPP vt 'rile' 
rins: vc;VNPPP VNPRB VRB prod tWord vt 'rinse' 
ripost: vc;VI VPP VTH count vi 'riposte' 
ripp: vc;VNPPP count statePhy vt 'rip' 
rippl: vc;VNPPP VPP VerbNom count natural 'ripple' 
ris: vc;VI VPP VPPPP VRB VerbNom count moreC statePhy vi 'rise' 
riv: vc;VNPRB VPP VRB looksChg vt 'rive' 
rivall: A vc;VI VIrecip VNPPP VNPPPas VPP VPPPP a count vt 'rival' 
romanticis: vc;VHOWSS VNPPP VNPPPas VPP chgEmo vt 'romanticise' 
romanticiz: vc;VHOWSS VNPPP VNPPPas VPP chgEmo vt 'romanticize' 
rootl: vc;VI VPP vi 'rootle' 
rop: vc;VerbNom prod tool vt 'rope' 
rotat: vc;VI VPP chgIsa move 'rotate' 
rott: vc;abstract vt worsen 'rot' 
roug: vc;VNPPP artifact vt 'rouge' 
rough-dri: vc;chgMeasure hyphenated vt 'rough-dry' 
rough-drie: vc;chgMeasure hyphenated vt 'rough-dry' 
rough-hous: vc;VI VPP hyphenated vi 'rough-house' 
roughhous: vc; 'roughhouse' 
rous: vc;VNPPP VNPTOoc VPP chgEmo feeling moreC vt 'rouse' 
rov: vc;VI VPP move vi 'rove' 
rowell: vc;count tool v 'rowel' 
rubb: vc;VNPPP VPP abstract count currency vt 'rub' 
rubie: nc;artifact 'ruby' 
rubifi: vc; 'rubify' 
rubifie: vc; 'rubify' 
rubricat: vc; 'rubricate' 
ruckl: vc; 'ruckle' 
ruffl: vc;count vt 'ruffle' 
ruggedis: vc;vt 'ruggedise' 
rul: vc;VNPAP VPP VPPas VPhisNG VTH VWHSS VerbNom artifact chg count pt vacOf 'rule' 
ruminat: vc;VI VPNGsc VPP VRB chgForm tryToKnow 'ruminate' 
rummag: vc;VPP abstract count tryToKnow 'rummage' 
rumpl: vc;VNPPP VRB looksChg 'rumple' 
runn: nc vc;VNPPP VNPPPPP VNPPPas VPP VPPPP VPPas VRB count vAP vt 'run' 
ruptur: vc;VPP statePhy vt 'rupture' 
rushe: vc;VI VNPPPdir VNPRB VPP VPPPP VPPPPdir VPPdir VRB VerbNom component dur plant vt 'rush' 
rusticat: vc;vt 'rusticate' 
rustl: vc;VPP abstract count natural v 'rustle' 
sabotag: vc;VerbNom botchW vt 'sabotage' 
saccharifi: vc;chgAttr 'saccharify' 
saccharifie: vc;chgAttr 'saccharify' 
sacrific: vc;VNPPP VerbNom animal 'sacrifice' 
saddl: vc;VNPPP ceaseMove count nt vt 'saddle' 
sagg: vc;VPP count length statePhy v 'sag' 
sailplan: vc;prod tool 'sailplane' 
salifi: vc; 'salify' 
salifie: vc; 'salify' 
salinat: vc; 'salinate' 
salivat: vc;vi 'salivate' 
salli: vc;VPP abstract count vt 'sally' 
sallie: vc;VPP abstract count vt 'sally' 
saltat: vc;vt 'saltate' 
salut: vc;VNPPNGoc VNPPP VNPPPas VerbNom artifact count 'salute' 
salv: vc;artifact vt 'salve' 
salvag: vc;VNPPNGoc VNPPPas VNPPPfor VPP VerbNom vt 'salvage' 
sanctifi: vc;pAttitude vt 'sanctify' 
sanctifie: vc;pAttitude vt 'sanctify' 
sandbagg: vc;artifact count 'sandbag' 
sanitat: vc;artifact vt 'sanitate' 
sanitis: vc;cleanse ize vt 'sanitise' 
sanitiz: vc;cleanse ize vt 'sanitize' 
saponifi: vc;vt 'saponify' 
saponifie: vc;vt 'saponify' 
sapp: vc;beBad lessC mkAct vt 'sap' 
sasse: vc;abstract v 'sass' 
satiat: vc;metabolize mkBetter vt 'satiate' 
satiriz: vc;VhisNG annoy vt 'satirize' 
satisfi: vc;pt vt 'satisfy' 
satisfie: vc;pt vt 'satisfy' 
saturat: vc;looksChg moveIn vt 'saturate' 
saut: vc;VNPPP VPP produce vt 'saute' 
sav: vc;VNPAP VNPPNGoc VNPPPas VNPPPfor VPP abstract count improve vVing vt 'save' 
savag: A vc;VNPPPas VerbNom a count per vt 'savage' 
savvi: A vc;VTH VWHSS a abstract vt 'savvy' 
savvie: A vc;VTH VWHSS a abstract vt 'savvy' 
scal: vc;VPP rank tool vt waste 'scale' 
scallopp: vc;animal vt 'scallop' 
scandalis: vc;attack vt 'scandalise' 
scandaliz: vc;attack playDown vt 'scandalize' 
scann: vc;VNPPPdir VRB abstract vt 'scan' 
scap: vc;component 'scape' 
scarifi: vc;chgAttr vt 'scarify' 
scarifie: vc;chgAttr vt 'scarify' 
scarr: vc;VRB lessC statePhy vt 'scar' 
scath: vc;abstract v 'scathe' 
scatt: vc;abstract v 'scat' 
scaveng: vc;VNPPP VPP chgLooks vt 'scavenge' 
sceptr: vc;count v 'sceptre' 
schedul: vc;VNPPP VNPPPas VNPPhisNG VNPTOoc count thinking timing vt 'schedule' 
schematis: vc;vt 'schematise' 
schlepp: vc;per v 'schlep' 
schmoos: vc;abstract 'schmoose' 
schmooz: vc;abstract v 'schmooze' 
scintillat: vc;enMove 'scintillate' 
scor: vc;VHOWSS VNPPP VPP count vt 'score' 
scorche: vc;VNPPP abstract count nt vt 'scorch' 
scorifi: vc;chgConnect 'scorify' 
scorifie: vc;chgConnect 'scorify' 
scourg: vc;VNPPP aggravateW count nt phenomena vt 'scourge' 
scrabbl: vc;VPP express vt 'scrabble' 
scragg: vc;count per vt 'scrag' 
scrambl: vc;VPP VPPdir VerbNom count vt vtoV 'scramble' 
scramm: vc;VI move vi 'scram' 
scrapp: vc;VI count enHidden give nt 'scrap' 
scratche: vc;VNPPP count lessC natural nt phenomena vt 'scratch' 
screeche: vc;VI VPP count natural v 'screech' 
scri: vc;deduce 'scry' 
scrib: vc;count tool v 'scribe' 
scribbl: vc;VPP abstract express vt 'scribble' 
scrie: vc;deduce 'scry' 
scroung: vc;VPP VPPPP take vt vtoV 'scrounge' 
scrubb: vc;VRB artifact count ntN per plant vt 'scrub' 
scrunche: vc;VNPPP VPP abstract count 'scrunch' 
scrupl: vc;VPNGsc VPP abstract count stateMental v 'scruple' 
scrutinis: vc;perV tryToKnow 'scrutinise' 
scrutiniz: vc;perV sense tryToKnow vt 'scrutinize' 
scudd: vc;VPPdir abstract vt 'scud' 
scumm: vc;per 'scum' 
scurri: vc;VPP VPPdir abstract count vt vtoV 'scurry' 
scurrie: vc;VPP VPPdir abstract count vt vtoV 'scurry' 
scuttl: vc;VPPdir count move vt 'scuttle' 
scyth: vc;count tool 'scythe' 
searche: vc;VI VNPPP VPP VPPPP VPPdir VerbNom count perOrgV useC vt 'search' 
seced: vc;VI VPP chgInclude separate vi 'secede' 
secernat: vc;tryToKnow 'secernate' 
seclud: vc;VNPPP chgConnect enHidden 'seclude' 
sectionalis: vc;vt 'sectionalise' 
secularis: vc;statePhy vt 'secularise' 
seculariz: vc;statePhy vt 'secularize' 
secur: A;VNPPPfor pt situation up vt 'secure' 
sedat: A;demeanor situation up vt 'sedate' 
seduc: vc;VNPPNGoc VNPPP VNPRB enDo vt 'seduce' 
seeth: vc;VI VPP looksChg move vi 'seethe' 
segregat: vc;VNPPP VPP chgConnect vt 'segregate' 
segu: vc;abstract v 'segue' 
sein: vc;VPP count vt 'seine' 
seiz: vc;VI VNPPP VNPPPas VPP chg vt 'seize' 
self-examin: vc;hyphenated tryToKnow 'self-examine' 
semaphor: vc;info v 'semaphore' 
sensibilis: vc; 'sensibilise' 
sensitis: vc;VNPPP chgAttr vt 'sensitise' 
sensitiz: vc;VNPPP chgAttr vt 'sensitize' 
sensualis: vc; 'sensualise' 
sentimentalis: vc;chgEmo vt 'sentimentalise' 
sentimentaliz: vc;VPP chgEmo vt 'sentimentalize' 
sentimentis: vc; 'sentimentise' 
sentimentiz: vc; 'sentimentize' 
sentrie: nc;count job 'sentry' 
separat: A;APP VI VIrecip VNPPP VNPPhisNG VPP abstract kind vt 'separate' 
sepulchr: vc;artifact count v 'sepulchre' 
serialis: vc;chgAttr vt 'serialise' 
serializ: vc;chgAttr express vt 'serialize' 
sermoniz: vc;VNPPP express vt 'sermonize' 
serrat: vc;vt 'serrate' 
serv: vc;VI VNPAP VNPPP VNPPPas VPP VPPas abstract count dative vAP vt vtoV 'serve' 
servic: vc;Key VNPPPas VPP comHN onV solution vacVTO vt vtoV 'service' 
settl: vc;VNPPP VNPRB VPNGsc VPP VPPdir VRB beNormal count decide 'settle' 
severalis: vc;tryToKnow 'severalise' 
severaliz: vc;tryToKnow 'severalize' 
sexe: vc;sex vt 'sex' 
sexualis: vc; 'sexualise' 
shackl: vc;VNPPP count lessC tool vt 'shackle' 
shak: vc;VNPAP VNPPPdir lessC vAP vt 'shake' 
shambl: vc;VI VPPdir abstract count nt vi 'shamble' 
shap: vc;VHOWSS VNPPP VerbNom looks phy vt 'shape' 
shar: vc;VI VNPPP VPP VTH VerbNom count vt 'share' 
shav: vc;VPP abstract count lessC vt 'shave' 
shedd: nc vc;VBDN VNPPNGoc VNPPP VPP artifact count vt 'shed' 
shelv: vc;chgMeasure vt 'shelve' 
shimm: vc;component tool v 'shim' 
shimmi: vc;abstract move 'shimmy' 
shimmie: vc;abstract move 'shimmy' 
shipp: vc;VNPPP VNPPPPP VNPRB VPP count dative group tool vt 'ship' 
shitt: A;abstract curse emph passion vt 'shit' 
shmooz: vc;abstract 'shmooze' 
shopp: vc;VI VPP VRB com count take useC vt 'shop' 
shor: vc;count vt 'shore' 
shov: vc;VNPPPdir abstract count vt 'shove' 
showcas: A vc;abstract artifact count 'showcase' 
shredd: vc;VNPPP component count quant vt 'shred' 
shrink-wrapp: vc;hyphenated prod v 'shrink-wrap' 
shriv: vc;sense vt 'shrive' 
shrugg: vc;VPP count vt 'shrug' 
shuffl: vc;VNPPPdir VPP VPPPP VPPPPdir VPPdir VerbNom count 'shuffle' 
shunn: vc;VNPPP refuse vt 'shun' 
shutt: vc;VBDN VNPPP openShut vt 'shut' 
shuttl: vc;VNPPPdir VPP VPPPP VPPdir VRB component count tool vt 'shuttle' 
sidestepp: vc;VNG abstract count leave vt 'sidestep' 
sidl: vc;VPPdir vt 'sidle' 
sightse: vc;whileAway 'sightsee' 
signaliz: vc;VTH looksChg vt 'signalize' 
signifi: vc;VTH VWHSS importance linkV mkOthersKnowledge vt 'signify' 
signifie: vc;VTH VWHSS importance linkV mkOthersKnowledge vt 'signify' 
silenc: vc;VerbNom situation vt 'silence' 
silicifi: vc;chgAttr 'silicify' 
silicifie: vc;chgAttr 'silicify' 
simplifi: vc;VNPPP VhisNG chgAttr chgQuant improve vt 'simplify' 
simplifie: vc;VNPPP VhisNG chgAttr chgQuant improve vt 'simplify' 
simulat: vc;act study 'simulate' 
singl: A vc;VNPPP count quant 'single' 
sinn: vc;Nom VI VPP nt vi 'sin' 
sipp: vc;VNPPP count vt 'sip' 
sitt: vc;VNPPP VNPRB VPP VPPPP VRB animalF move perF 'sit' 
situat: A vc;timeOrSpace vt 'situate' 
siz: vc;VNPPP natural range size vt 'size' 
skat: vc;VPPdir vt whileAway 'skate' 
skedaddl: vc;VPP VRB abstract v 'skedaddle' 
sketche: A;count troubleW vt 'sketch' 
skidd: vc;VPP VPPdir VerbNom component count 'skid' 
skie: nc;count natural 'sky' 
skii: vc;VPPdir count vt 'ski' 
skimm: A;VNPPPdir VPP chgForm hold tryToKnow vt 'skim' 
skinny-dipp: vc;hyphenated move 'skinny-dip' 
skipp: vc;VPPdir abstract count vt 'skip' 
skirmishe: vc;VI VPP VerbNom count vi 'skirmish' 
skittl: vc;VI count vi 'skittle' 
skydiv: vc;whileAway 'skydive' 
slak: vc;enHidden 'slake' 
slamm: vc;VNPPP VNPRB VPP count nt vt 'slam' 
slapp: vc;VNPPPdir VNPRB VerbNom count vt 'slap' 
slashe: vc;VI VNPPP VPP VerbNom count natural nt vt 'slash' 
sledd: vc;count tool v 'sled' 
sledg: vc;VNPPPdir VPP count tool vt 'sledge' 
slenderis: vc; 'slenderise' 
slic: vc;VNPPP VPP VRB component count phy quant vt 'slice' 
slipp: vc;VI VNPPPdir VNPRB VPP VPPPP VPPdir VRB VerbNom vt 'slip' 
slitt: vc;count vt 'slit' 
slogg: vc;VPPdir VRB move vt 'slog' 
slopp: vc;VNPPPdir VPPdir VRB vt waste 'slop' 
slu: vc;quant 'slue' 
slugg: vc;VNPPP VRB animal artifact vt 'slug' 
slumm: vc;VI artifact count vi 'slum' 
slurr: vc;VPP VerbNom count nt vt worthy 'slur' 
smashe: vc;VNPPP VPP abstract count vt 'smash' 
smil: vc;VI VPP VerbNom count vi 'smile' 
smirche: vc;chgLooks count playDown vt 'smirch' 
smok: vc;VerbNom natural ntN 'smoke' 
smooche: vc;abstract v 'smooch' 
smuggl: vc;VNPPP nt send vt 'smuggle' 
smutche: vc;v waste 'smutch' 
smutt: vc;nt phenomena vt worthy 'smut' 
snaffl: vc;count vt 'snaffle' 
snagg: vc;VI VNPPP VPP VerbNom component count nt vt 'snag' 
snapp: vc;VNPPPdir VNPRB VPP VRB component count vt 'snap' 
snar: vc;VNPPNGoc VNPPP VPP nt thinking vt 'snare' 
snatche: vc;VNPPP VPP abstract vt 'snatch' 
sneez: vc;VNPPP moveOut vi 'sneeze' 
sniffl: vc;VI moveIn vi 'sniffle' 
snipp: vc;count vt 'snip' 
snitche: vc;VPP per vt 'snitch' 
snogg: vc;chgForm 'snog' 
snooz: vc;VI cease count vi 'snooze' 
snor: vc;VI count natural vi 'snore' 
snowmobil: vc;VI count prod tool 'snowmobile' 
snowsho: vc;prod tool 'snowshoe' 
snubb: vc;attack count nt vtPer 'snub' 
snuffl: vc;VRB count natural vt 'snuffle' 
snuggl: vc;VNPPP VPP VRB abstract vt 'snuggle' 
sobb: vc;VI count negAdj v 'sob' 
socialis: vc;VNPPP VNPTOoc VPP VRB chgAttr tie vt 'socialise' 
socializ: vc;VNPPP VNPTOoc VPP VRB chgAttr tie vt 'socialize' 
societie: nc;abstract orgHN situation 'society' 
sodd: vc;artifact vt 'sod' 
solac: vc;VerbNom mental 'solace' 
solaris: vc;chgLooks vt 'solarise' 
solariz: vc;chgLooks chgMeasure vt 'solarize' 
solemnifi: vc;chgAttr 'solemnify' 
solemnifie: vc;chgAttr 'solemnify' 
solemnis: vc;vt 'solemnise' 
solidifi: vc;VPP chgLooks chgProperty looksChg 'solidify' 
solidifie: vc;VPP chgLooks chgProperty looksChg 'solidify' 
soliloquis: vc;mkSound 'soliloquise' 
soliloquiz: vc;mkSound vt 'soliloquize' 
solv: vc;correctW vt 'solve' 
solvat: vc;VerbNom prod vt 'solvate' 
somnambulat: vc;move vt 'somnambulate' 
sorceris: vc; 'sorcerise' 
spac: vc;abstract content vt 'space' 
spackl: vc;prod v 'spackle' 
spad: vc;VNPPP component count tool vt 'spade' 
spamm: vc;aggravateW troubleW v 'spam' 
spann: vc;VPP VPPPP VerbNom count length range vt 'span' 
sparg: vc;abstract v 'sparge' 
sparkl: ;VI VPP VerbNom count pt v 'sparkle' 
sparr: vc;VIrecip VPNGsc VPP VPPPP count natural tool 'spar' 
specialis: vc;tWord vt 'specialise' 
specializ: vc;VPNGsc VPP tWord tryToKnow vt 'specialize' 
specifi: vc;VPPhowTO VTH VWHSS chgProperty vt 'specify' 
specifie: vc;VPPhowTO VTH VWHSS chgProperty vt 'specify' 
speckl: vc;count natural v 'speckle' 
spectat: vc;sense 'spectate' 
speculat: vc;VPP VPhisNG VSS VTH VWHSS deduce rashlyAct 'speculate' 
speechifi: vc;VI mkSound 'speechify' 
speechifie: vc;VI mkSound 'speechify' 
sphacelat: vc;phenomena 'sphacelate' 
spi: vc;VPP count job vt 'spy' 
spie: vc;VPP count job vt 'spy' 
spin-dri: vc;chgMeasure hyphenated vt 'spin-dry' 
spin-drie: vc;chgMeasure hyphenated vt 'spin-dry' 
spinn: vc;VNPPPfor VPP phy prod0 'spin' 
spiritualis: vc;vt 'spiritualise' 
spitt: nc vc;VBDN VNPPPdir VPP VPPdir chg vt 'spit' 
splashe: vc;VNPPPdir VPPdir abstract count natural vt 'splash' 
splitt: nc vc;VBDN VI VNPPP VPP VerbNom component count statePhy vt 'split' 
spong: vc;VNPPP artifact count vt 'sponge' 
spor: vc;component count 'spore' 
spott: vc;VNPPPas VRB abstract count tWord vt 'spot' 
spreadeagl: vc;count vt 'spreadeagle' 
sprinkl: vc;VNPPP VPP goOut moveDown moveOut vt 'sprinkle' 
spruc: vc;plant v 'spruce' 
spudd: vc;create 'spud' 
spurr: vc;VI VNPPP VNPRB VNPTOoc VerbNom VhisNG artifact component count phenomena vt 'spur' 
squar: vc;VNPPP count looks vt 'square' 
squashe: vc;VNPAP VNPPP VPP VRB moveOut remove vt 'squash' 
squatt: A;VI VPP move nt tWord vi 'squat' 
squeege: vc;count tool vt 'squeegee' 
squeez: vc;VNPAP VNPPPdir VPP VPPdir VRB VerbNom count lessC vAP vt 'squeeze' 
squelche: vc;abstract count vt 'squelch' 
squibb: vc;artifact count 'squib' 
squinche: vc;enMove 'squinch' 
squishe: vc;abstract natural v 'squish' 
stabb: vc;VNPPP VPP count phenomena vt 'stab' 
stabilis: vc;promoteW vt 'stabilise' 
stabiliz: vc;chg promoteW 'stabilize' 
stagnat: vc;VI VPP chgLoc 'stagnate' 
stalinis: vc; 'stalinise' 
standardis: vc;chgAttr vt 'standardise' 
standardiz: vc;chgAttr vt 'standardize' 
stargaz: vc;feeling 'stargaze' 
starr: A vc;Nom VNPPP VPP count natural per vt 'star' 
startl: vc;VNPAP nEmo vt 'startle' 
starv: vc;VI VNPPNGoc VNPPP VPP beBad mkAct vtPer 'starve' 
stashe: vc;VNPPP VNPRB abstract space vt 'stash' 
staunche: A;behavior vt 'staunch' 
stav: vc;count prod v 'stave' 
steadi: A;count situation vt 'steady' 
steadie: A;count situation vt 'steady' 
stemm: vc;VNPPP VPP abstract component count vt 'stem' 
stepp: vc;Nom VPP VPPdir count length solution speed tWord thinking vacTo vacVTO vtoV xiangV 'step' 
sterilis: vc;mkBad vt 'sterilise' 
steriliz: vc;mkBad vt 'sterilize' 
stett: vc;beNormal 'stet' 
stickl: vc;chgFit 'stickle' 
stifl: vc;causeNotDo ill vt 'stifle' 
stigmatis: vc;annoy vt 'stigmatise' 
stigmatiz: vc;VNPPNGoc VNPPP VNPPPas annoy vt 'stigmatize' 
stimulat: vc;VNPPNGoc VNPTOoc VhisNG chgEmo promoteW vt 'stimulate' 
stipulat: A vc;VNPPP VTH chgProperty decide vt 'stipulate' 
stir-fri: vc;hyphenated produce 'stir-fry' 
stir-frie: vc;hyphenated produce 'stir-fry' 
stitche: vc;VNPPP natural 'stitch' 
stockpil: vc;VerbNom artifact count vt 'stockpile' 
stomache: vc;VhisNG bodyPart component count vt 'stomach' 
stoog: vc;VPP VerbNom count per v 'stooge' 
stopp: vc;VI VNG VNPNGoc VNPPNG VNPPP VNPPhisNG VNPRB VPP VRB VerbNom artifact count remove statePhy vVing vt 'stop' 
stoppl: vc;component 'stopple' 
stor: vc;VNPPP VNPRB count group solution vt 'store' 
straddl: vc;abstract move vt 'straddle' 
straf: vc;abstract chgForm vt 'strafe' 
straggl: vc;VPPdir abstract chgFit move quality 'straggle' 
strangl: vc;aggravateW mkBad vt 'strangle' 
strangulat: vc;mkBad vt 'strangulate' 
strapp: vc;VNPPP count prod tool vt 'strap' 
strategie: nc;Nom solution tWord thinking vacFor vacOf vtoV 'strategy' 
stratifi: vc;VNPPP chgAttr vt 'stratify' 
stratifie: vc;VNPPP chgAttr vt 'stratify' 
streamlin: vc;VNPPP pt vt 'streamline' 
stresse: vc;VHOWSS VNPPP VPPTH VSS VTH VerbNom problem vt 'stress' 
stretche: A;VI VNPAP VNPPPPP VNPPPdir VPP VPPPP VPPdir VerbNom count moreC n statePhy vAP vt 'stretch' 
strickl: vc;tool v 'strickle' 
strid: vc;VPPdir count length 'stride' 
strik: vc;VI VNPAP VNPPP VNPPPas VPP VerbNom count vt 'strike' 
strip-searche: vc;hyphenated tryToKnow 'strip-search' 
stripp: vc;VNPAP VNPPP count prod vAP vt 'strip' 
striv: vc;VPP needForW take vtoV 'strive' 
strok: vc;VerbNom phenomena statePhy vt 'stroke' 
stropp: vc;component count tool vt 'strop' 
structur: vc;VNPPP VNPPPas VNPTOoc abstract artifact component looks vacOf vt 'structure' 
structuraliz: vc;chgAttr 'structuralize' 
struggl: vc;VI VPNGsc VPP VPPdir VRB VerbNom count suffer troubleW vtoV 'struggle' 
strumm: vc;VPP count vt 'strum' 
stubb: vc;component count vt 'stub' 
studi: vc;VNPPP VPP VerbNom infoV infosourceN perOrgV tWord vacOf vt vtoV 'study' 
studie: vc;VNPPP VPP VerbNom infoV infosourceN perOrgV tWord vacOf vt vtoV 'study' 
stultifi: vc;mkBad vt 'stultify' 
stultifie: vc;mkBad vt 'stultify' 
stumbl: vc;VPP VPPdir VerbNom count move vi 'stumble' 
stumm: vc;causeNotDo 'stum' 
stunn: vc;emph nt passion vt 'stun' 
stupefi: vc;annoy vt 'stupefy' 
stupefie: vc;annoy vt 'stupefy' 
stupifi: vc;vt 'stupify' 
stupifie: vc;vt 'stupify' 
styl: vc;abstract artifact component looks vt 'style' 
styliz: vc;chgAttr vt 'stylize' 
stymi: vc;causeNotDo 'stymy' 
subdu: vc;chgAttr haveContest vt 'subdue' 
subjectifi: vc;express 'subjectify' 
subjectifie: vc;express 'subjectify' 
subjugat: vc;haveContest injureW vt 'subjugate' 
sublett: nc vc;VBDN VNPPP abstract perF vt 'sublet' 
sublimat: vc;VNPPP chgProperty looksChg vt 'sublimate' 
subluxat: vc;ill vt 'subluxate' 
submerg: vc;VNPPP VPP beNormal move 'submerge' 
submers: vc;vt 'submerse' 
submitt: vc;VNPPP VNPPPas VPP VPhisNG VTH give obey 'submit' 
subscrib: vc;VPP give take vt 'subscribe' 
subserv: vc;enDo vt 'subserve' 
subsid: vc;VI lessC move quantChg 'subside' 
subsidiz: vc;give vt 'subsidize' 
substantiat: vc;VTH improve tWord tryToKnow vt 'substantiate' 
substitut: A nc vc;VNPPP VNPPPas VPP count per tWord vt 'substitute' 
subsum: vc;containV inclusive tWord vt 'subsume' 
suburbanis: vc;chgAttr 'suburbanise' 
suburbaniz: vc;chgAttr 'suburbanize' 
suckl: vc;metabolize vt 'suckle' 
sudat: vc;metabolize vt 'sudate' 
suffic: vc;VPP chg vt 'suffice' 
suffocat: vc;VNPPP VPP attack ill 'suffocate' 
suffus: vc;VNPPP chgPhy 'suffuse' 
sulfat: vc;artifact 'sulfate' 
sulfonat: vc;artifact 'sulfonate' 
sulli: vc;VNPPP aggravateW playDown vt 'sully' 
sullie: vc;VNPPP aggravateW playDown vt 'sully' 
sulphat: vc;artifact 'sulphate' 
summ: vc;artifact count quant vt 'sum' 
summaris: vc;infoV vt 'summarise' 
summariz: vc;VNPPP VNPPPas VRB express infoV vt 'summarize' 
summat: ;Math 'summate' 
summeris: vc;act 'summerise' 
summeriz: vc;act 'summerize' 
sunbath: vc;VI VPP chgMeasure vi 'sunbathe' 
sunn: vc;VNPPP natural vt 'sun' 
supercharg: vc; 'supercharge' 
superimpos: vc;VNPPP enMove vt 'superimpose' 
superordinat: A vc;component v 'superordinate' 
superpos: vc;vt 'superpose' 
superscrib: vc;vt 'superscribe' 
supersed: vc;VNPPP VNPPPas chgIsa vt 'supersede' 
superven: vc;VPP vt 'supervene' 
supervis: vc;VHOWSS VI VNPPPas VNPRB VRB check control vt 'supervise' 
supinat: vc;vt 'supinate' 
supp: nc vc;VPP abstract count 'sup' 
suppli: vc;VNPPP VerbNom pt vacTo vacWith vt 'supply' 
supplicat: vc;VNPPP VNPPPas VPP enDo 'supplicate' 
supplie: vc;VNPPP VerbNom pt vacTo vacWith vt 'supply' 
suppos: vc;VNPAP VNPNP VNPTObe VSS VTH deduce haveKnowledge perV vt 'suppose' 
suppresse: vc;VHOWSS remove vt 'suppress' 
suppurat: vc;ill vi 'suppurate' 
surfac: vc;VNPPP VPP VPPas component looks vt 'surface' 
surg: vc;VI VPP VPPdir VerbNom stateMental tWord 'surge' 
surmis: vc;VNPPP VSS abstract count deduce vt 'surmise' 
surpasse: vc;VNPPP VNPPPas succeed tWord vt 'surpass' 
surviv: vc;VPP VPPas beNormal pt 'survive' 
suspir: vc;metabolize vt 'suspire' 
susurrat: vc;express vt 'susurrate' 
swabb: vc;VNPRB count prod tool vt 'swab' 
swaddl: vc;VNPPP vt 'swaddle' 
swapp: vc;VIrecip VNPPP VPP VerbNom count 'swap' 
swashe: vc;behavior 'swash' 
swatt: vc;VNPAP VPP VerbNom count 'swat' 
swerv: vc;VNPPPdir VPPdir chg count vt 'swerve' 
swimm: vc;VPPdir abstract count vt 'swim' 
swindl: vc;VNPPP count injureW vtPer 'swindle' 
swip: vc;VNPPP abstract count vt 'swipe' 
swishe: vc;abstract count natural vt 'swish' 
switche: vc;VIrecip VNPPP VNPPPPP VPNGsc VPP VPPPP component count tWord tool vt 'switch' 
swivell: A vc;VNPPP count tool vt 'swivel' 
swobb: vc;count prod tool v 'swob' 
swopp: vc;VIrecip VNPPP VPP abstract count vt 'swop' 
swott: vc;count vt 'swot' 
syllabicat: vc;VNPPP VNPPPas VPPas chgConnect 'syllabicate' 
syllabifi: vc;VNPPP VNPPPas VPPas chgConnect 'syllabify' 
syllabifie: vc;VNPPP VNPPPas VPPas chgConnect 'syllabify' 
syllabis: vc;chgConnect vt 'syllabise' 
syllabiz: vc;chgConnect vt 'syllabize' 
symbolis: vc;beC chgAttr vt 'symbolise' 
symboliz: vc;VNPPP VNPPPas VNPPhisNG VPPTH VPPas VPPhowTO VTH VWHSS beC chgAttr 'symbolize' 
symmetris: vc; 'symmetrise' 
sympathis: vc;vi 'sympathise' 
sympathiz: vc;VI VPP VPPPP VPhisNG VRB nAttitude vi 'sympathize' 
symphonie: nc;count org 'symphony' 
synchronis: vc;appear vt 'synchronise' 
synchroniz: vc;VNPPP VPP appear sequence 'synchronize' 
syncopat: vc;VNPPP VPP 'syncopate' 
syncretis: vc; 'syncretise' 
syndicat: vc;VNPPP VNPPPas com count orgHN vt 'syndicate' 
synopsiz: vc;express 'synopsize' 
synthesiz: vc;VNPPP VNPPPas VPP chgInclude create tWord vacVO 'synthesize' 
systematis: vc;chgAttr vt 'systematise' 
systematiz: vc;chgAttr 'systematize' 
systemis: vc;chgAttr 'systemise' 
systemiz: vc;chgAttr 'systemize' 
tabl: vc;count infosourceN tool vt 'table' 
tabularis: vc;create 'tabularise' 
tabulariz: vc;create 'tabularize' 
tabulat: vc;VNPPP VNPTObe create vt 'tabulate' 
tackl: vc;artifact component pt vt 'tackle' 
tagg: vc;VNPPP abstract count vt 'tag' 
tailgat: vc;count 'tailgate' 
tak: vc;VI VNPPPas VNPPPdir VNPTObe VNPTOoc VPNGsc VPP VWHSS abstract count dative tWord vacVO vt 'take' 
talli: vc;VNPPP VPP VerbNom count result vt 'tally' 
tallie: vc;VNPPP VPP VerbNom count result vt 'tally' 
tangl: vc;VIrecip VPP count v 'tangle' 
tantaliz: vc;VNPPP enDo vt 'tantalize' 
tapp: vc;VNPPP VNPRB VNPTOoc VPP artifact component vt 'tap' 
tarnishe: vc;abstract color vt 'tarnish' 
tarri: vc;VRB act vt 'tarry' 
tarrie: vc;VRB act vt 'tarry' 
tatt: vc;abstract chgForm 'tat' 
tattl: vc;VPP abstract vt 'tattle' 
taxe: vc;Nom VNPNP VNPPP VPP artifact vt 'tax' 
teache: vc;VNPTOoc VPPhowTO dative perF 'teach' 
teargase: vc;prod tool 'teargas' 
technologie: nc;Nom VPPforTO abstract prod tWord vacFor vacVTO vtoV 'technology' 
telecommunicat: vc;vt 'telecommunicate' 
telephon: vc;count prod tool vt 'telephone' 
telexe: vc;count tool 'telex' 
temporis: vc;vi 'temporise' 
temporiz: vc;VI vi 'temporize' 
tenderis: vc;vt 'tenderise' 
tepefi: vc;chgMeasure 'tepefy' 
tepefie: vc;chgMeasure 'tepefy' 
terminat: vc;VNPPPas VPP VPPNG remove 'terminate' 
terrifi: vc;VNPPNGoc VNPPP annoy emph passion vtPer 'terrify' 
terrifie: vc;VNPPNGoc VNPPP annoy emph passion vtPer 'terrify' 
territorialis: vc;vt 'territorialise' 
territorie: nc;count 'territory' 
terroris: vc;annoy vtPer 'terrorise' 
terroriz: vc;annoy emph passion vtPer 'terrorize' 
test-fir: vc;hyphenated send 'test-fire' 
testifi: vc;VI VPNGsc VPP VPPTH VPPas VSS VTH VWHSS mkOwnKnowledge 'testify' 
testifie: vc;VI VPNGsc VPP VPPTH VPPas VSS VTH VWHSS mkOwnKnowledge 'testify' 
thatche: vc;prod tool vt 'thatch' 
theorie: nc;Nom VTH mental onV vacOf 'theory' 
theoriz: vc;VPP VTH chgAttr vt 'theorize' 
thiev: vc;take vt 'thieve' 
thoriat: vc; 'thoriate' 
thrashe: vc;abstract vt 'thrash' 
threshe: vc;enAppear 'thresh' 
thriv: vc;VI VPP situation succeed vi 'thrive' 
throbb: vc;VI chg 'throb' 
throttl: vc;component count tool vt 'throttle' 
thrumm: vc;VPP vt whileAway 'thrum' 
thudd: vc;VI VPP count vi 'thud' 
thurifi: vc; 'thurify' 
thurifie: vc; 'thurify' 
tickl: vc;abstract vt 'tickle' 
tidi: A;content count looks up vt 'tidy' 
tidie: A;content count looks up vt 'tidy' 
tingl: vc;abstract count statePhy vt 'tingle' 
tinkl: vc;VPP abstract count natural vt 'tinkle' 
tinplat: vc;natural 'tinplate' 
tipp: vc;VNPNP abstract artifact component count onV vacOf vt 'tip' 
tippl: vc;abstract vt 'tipple' 
tipto: vc;VPP VPPdir component 'tiptoe' 
tir: vc;VPP component count passion prod vt 'tire' 
tith: vc;abstract count v 'tithe' 
titillat: vc;chgEmo vt 'titillate' 
titivat: vc;vt 'titivate' 
toadi: vc;VI VPP count per vi 'toady' 
toadie: vc;VI VPP count per vi 'toady' 
toddl: vc;VPP VPPdir move 'toddle' 
togg: vc;cover 'tog' 
toggl: vc;count prod tool v 'toggle' 
tolerat: vc;VNPNGoc VhisNG emph passion undergo vt 'tolerate' 
tonsur: vc;count v 'tonsure' 
tootl: vc;VPP abstract count vt 'tootle' 
toppl: vc;VPP enMove move vt 'topple' 
torrefi: vc;chgMeasure 'torrefy' 
torrefie: vc;chgMeasure 'torrefy' 
tortur: vc;VNPPP curse injureW vtPer 'torture' 
tosse: vc;VNPPPdir abstract count vt 'toss' 
totalis: vc; 'totalise' 
trac: vc;VNPPP VNPPhisNG count quant vacOf vt 'trace' 
traduc: vc;playDown vt 'traduce' 
tramm: vc;count tool 'tram' 
trampl: vc;VNPPP VPP abstract attack chgForm count mkBad vt 'trample' 
tranquiliz: vc;chgEmo vt 'tranquilize' 
tranquillis: vc; 'tranquillise' 
tranquilliz: vc;situation vt 'tranquillize' 
transcrib: vc;VNPPP vt write 'transcribe' 
transfigur: vc;VNPPP chgLooks looksChg vt 'transfigure' 
transfixe: vc;VNPPP chgForm vt 'transfix' 
transfus: vc;VNPPP mkOthersKnowledge vt 'transfuse' 
transgresse: vc;VPP chgFit goThrough vt 'transgress' 
transitivis: vc; 'transitivise' 
translat: vc;VNPPP VNPPPPP VNPPPas VPP express 'translate' 
transliterat: vc;VNPPP express vt 'transliterate' 
translocat: vc;chgLoc vt 'translocate' 
transmigrat: vc;exist vt 'transmigrate' 
transmitt: vc;VNPPP express give send vt 'transmit' 
transmogrifi: vc;VI VNPPP VPP chgLooks 'transmogrify' 
transmogrifie: vc;VI VNPPP VPP chgLooks 'transmogrify' 
transmut: vc;VNPPP VPP chg statePhy vt 'transmute' 
transpir: vc;VI give 'transpire' 
transpos: vc;VNPPP abstract vt 'transpose' 
transud: vc;moveOut vt 'transude' 
trapp: vc;VNPPP VNPPhisNG VerbNom artifact count nt thinking vt 'trap' 
traumatis: vc;annoy vtPer 'traumatise' 
traumatiz: vc;annoy vtPer 'traumatize' 
travell: vc;VNPPPPP VNPPPdir VPP VPPPP VPPdir VRB VerbNom 'travel' 
travers: vc;VPP VerbNom component count vt 'traverse' 
travesti: vc;abstract bad count 'travesty' 
travestie: vc;abstract bad count 'travesty' 
treadl: vc;component count prod tool v 'treadle' 
treatie: nc;count 'treaty' 
trebl: A vc;VNPPP abstract count vt 'treble' 
trekk: vc;VPPPP VPPdir abstract count 'trek' 
trellise: vc;artifact count vt 'trellis' 
trembl: vc;VI VPP count vtoV 'tremble' 
trephin: vc;VNPPP count tool vt 'trephine' 
tri: vc;VI VNG VNPPP VPP VWHSS VerbNom act count currency mental useC vVing vt vtoV 'try' 
tribulat: vc;vt 'tribulate' 
tric: vc;count timeUnit vt 'trice' 
trickl: vc;VPPdir abstract count 'trickle' 
trie: vc;VI VNG VNPPP VPP VWHSS VerbNom act count currency mental useC vVing vt vtoV 'try' 
trifl: vc;VPP count v 'trifle' 
trigg: A vc;a abstract v 'trig' 
trimm: vc;VNPPP VhisNG abstract count lessC prod0 situation vt vtoV 'trim' 
tripl: A vc;RB VPP abstract vt 'triple' 
triplicat: vc;count v 'triplicate' 
trophie: nc;artifact count 'trophy' 
trott: vc;VNPPPdir VPPdir abstract count 'trot' 
troubl: vc;VNPPP attack curse easiness problem vt vtoV 'trouble' 
trounc: vc;chgForm vt 'trounce' 
truckl: vc;count 'truckle' 
truncat: A vc;VNPPP chgForm vt 'truncate' 
trusse: vc;VNPPP artifact component count vt 'truss' 
tugg: vc;VNPPP VPP abstract count tool vt 'tug' 
tumbl: vc;VNPPP VPP VPPPP VPPdir VerbNom count nt 'tumble' 
tumefi: vc;ill vt 'tumefy' 
tumefie: vc;ill vt 'tumefy' 
tumesc: vc;statePhy 'tumesce' 
tunn: nc;count v 'tun' 
tupp: vc;count v 'tup' 
tussl: vc;VIrecip VPP abstract count vt 'tussle' 
tutt: vc; 'tut' 
twaddl: vc;abstract v 'twaddle' 
tweedl: vc; 'tweedle' 
tweez: vc; 'tweeze' 
twiddl: vc;VPP abstract count vt 'twiddle' 
twigg: vc;component count vt 'twig' 
twinkl: vc;abstract count vt 'twinkle' 
twitche: vc;VRB statePhy vt 'twitch' 
twitt: vc;VNPPP count per vt 'twit' 
typ: vc;VNPPP VNPPPas abstract artifact classUnit kind looks vacOf vt 'type' 
typesett: vc;VBDN mkBetter 'typeset' 
typewrit: vc;express hold 'typewrite' 
typifi: vc;chgAttr vt 'typify' 
typifie: vc;chgAttr vt 'typify' 
uglifi: vc;playDown vt 'uglify' 
uglifie: vc;playDown vt 'uglify' 
ulcerat: vc;ill vt 'ulcerate' 
ululat: vc;VI VPP vi 'ululate' 
unbarr: vc;openShut vt 'unbar' 
unbrac: vc;enGrow separate 'unbrace' 
unbridl: vc; 'unbridle' 
unbuckl: vc;vt 'unbuckle' 
uncapp: vc;enAppear 'uncap' 
unclenche: vc; 'unclench' 
unclipp: vc; 'unclip' 
unclogg: vc;chgProperty 'unclog' 
undeceiv: vc;VNPPP know vt 'undeceive' 
underachiev: vc;vt 'underachieve' 
underbidd: vc;VNPPP VPP express vt 'underbid' 
undercharg: vc;VNPNP VNPPP VPP VPPPP count vt 'undercharge' 
undercutt: nc vc;VBDN abstract vt 'undercut' 
underestimat: vc;VHOWSS abstract count stateMental troubleW vt 'underestimate' 
underexpos: vc;vt 'underexpose' 
underli: vc;hold vt 'underlie' 
underlin: vc;VTH abstract count express vt 'underline' 
undermin: vc;attack mkBad vt 'undermine' 
underpinn: vc;VNPPP hold promoteW vt 'underpin' 
underrat: vc;mkOwnKnowledge vt 'underrate' 
underscor: vc;VHOWSS VTH abstract vt 'underscore' 
understudi: vc;count job vt 'understudy' 
understudie: vc;count job vt 'understudy' 
undertak: vc;VNG VNPPPas bear vacVO vt vtoV 'undertake' 
undervalu: vc;mkOwnKnowledge vt 'undervalue' 
underwrit: vc;VNPPPas pEmo vt 'underwrite' 
undrap: vc;openShut 'undrape' 
undresse: vc;abstract artifact vt 'undress' 
undulat: vc;move 'undulate' 
unfreez: vc;chgGood looksChg 'unfreeze' 
unhing: vc;vt 'unhinge' 
unhitche: vc;VNPPP separate vt 'unhitch' 
unifi: vc;VNPPPas associate 'unify' 
unifie: vc;VNPPPas associate 'unify' 
uniformis: vc; 'uniformise' 
unimpresse: vc;annoy 'unimpress' 
unit: vc;VIrecip VNPPP VPNGsc VPP associate
unitis: vc;vt 'unitise' 
unlac: vc;separate vt 'unlace' 
unlashe: vc;separate 'unlash' 
unlaxe: vc;enGrow 'unlax' 
unleashe: vc;VNPPP enMove vt 'unleash' 
unmak: vc;enHidden 'unmake' 
unmann: vc;enHidden 'unman' 
unnerv: vc;annoy vtPer 'unnerve' 
unpinn: vc;moveOut 'unpin' 
unplugg: vc;moveOut vt 'unplug' 
unravell: vc;VI chgConnect vt 'unravel' 
unrigg: vc;enMove 'unrig' 
unsaddl: vc;vt 'unsaddle' 
unscrambl: vc;express vt 'unscramble' 
unsettl: vc;attack vtPer 'unsettle' 
unsheath: vc;enAppear vt 'unsheathe' 
unstapl: vc; 'unstaple' 
unsubstantialis: vc; 'unsubstantialise' 
untangl: vc;separate 'untangle' 
unti: vc;VNPPP chgMeasure separate vt 'untie' 
untun: vc; 'untune' 
untwin: vc; 'untwine' 
unweav: vc; 'unweave' 
unwrapp: vc;openShut vt 'unwrap' 
unzipp: vc;separate vt 'unzip' 
updat: vc;VNPPP VerbNom vt 'update' 
upgrad: A vc;VI VNPPP VPP VPPPP VerbNom count improve useC vt 'upgrade' 
upheav: vc;chg vt 'upheave' 
uprais: vc;chgAttr chgGood 'upraise' 
upris: vc;fight move 'uprise' 
upsett: vc;APP VBDN abstract annoy attack count passion pred vt 'upset' 
upstag: A;RB behavior vt 'upstage' 
urbanis: vc;chgAttr vt 'urbanise' 
urbaniz: vc;chgAttr vt 'urbanize' 
urg: vc;Nom VNPPPdir VNPRB VNPTOoc VPP VPhisNG VSS VTH VhisNG count needForW perOrgV vtPer vtoV 'urge' 
urinat: vc;metabolize vi 'urinate' 
utilis: vc;VNPTOsc pt useC vacVO vt 'utilise' 
utiliz: vc;VNPPNGsc VNPPP VNPPPas VNPTOsc mkAct pt useC vacVO vt 'utilize' 
vacat: vc;enHidden moveOut 'vacate' 
vaccinat: vc;VNPPP resume vt 'vaccinate' 
vacillat: vc;VI VPP troubleW vi volition 'vacillate' 
validat: vc;pEmo tWord vt 'validate' 
valoriz: vc;chgProperty 'valorize' 
valu: vc;VNPPP abstract info vacOf vt worth 'value' 
valuat: vc;tryToKnow 'valuate' 
vandaliz: vc;mkBad 'vandalize' 
vanishe: vc;VI VPP chgTime statePhy vi 'vanish' 
vanquishe: vc;haveContest remove vtPer 'vanquish' 
vaporis: vc;vt 'vaporise' 
vaporiz: vc;chgAttr move statePhy 'vaporize' 
vari: vc;VNPPP VNPPPPP VPP VPPPP VRB chgAttr chgIsa statePhy 'vary' 
varie: vc;VNPPP VNPPPPP VPP VPPPP VRB chgAttr chgIsa statePhy 'vary' 
variegat: vc;beC chgAttr vt 'variegate' 
varietie: nc;abstract kind 'variety' 
vascularis: vc;vt 'vascularise' 
vasectomis: vc;enHidden 'vasectomise' 
vasectomiz: vc;enHidden 'vasectomize' 
vaticinat: vc;deduce vt 'vaticinate' 
vatt: vc;count prod 'vat' 
vegetat: vc;VI beNormal vi 'vegetate' 
vellicat: vc;take vt 'vellicate' 
velocitie: nc;speed 'velocity' 
venerat: vc;VNPPP pAttitude vt 'venerate' 
ventilat: vc;chgLooks chgMental chgProperty vt 'ventilate' 
ventur: vc;VPP VTH VerbNom act vtoV 'venture' 
verbalis: vc;mkSound vt 'verbalise' 
verbaliz: vc;VNPPP mkSound vt 'verbalize' 
verbifi: vc;chgAttr 'verbify' 
verbifie: vc;chgAttr 'verbify' 
verifi: vc;VTH tWord tryToKnow vt 'verify' 
verifie: vc;VTH tWord tryToKnow vt 'verify' 
vernaliz: vc;chgAttr 'vernalize' 
versifi: vc;produce vt 'versify' 
versifie: vc;produce vt 'versify' 
vesiculat: vc;appear vt 'vesiculate' 
vestur: vc;tool v 'vesture' 
vexe: vc;attack vtPer 'vex' 
vibrat: vc;move 'vibrate' 
victimis: vc;injureW mkAct vtPer 'victimise' 
victimiz: vc;give injureW mkAct vtPer 'victimize' 
videotap: vc;VNPNGoc artifact vt 'videotape' 
vilifi: vc;attack playDown vtPer 'vilify' 
vilifie: vc;attack playDown vtPer 'vilify' 
vindicat: vc;VNPPP chgIsa mkOwnKnowledge vt 'vindicate' 
violat: A vc;aggravateW chgFit mkBad vt 'violate' 
virilis: vc;vt 'virilise' 
visualis: vc;create tryToKnow vt 'visualise' 
visualiz: vc;VNPNG VNPPP VNPPPas create deduce vt 'visualize' 
vitalis: vc;promoteW vt 'vitalise' 
vitaliz: vc;chgEmo chgState promoteW vt 'vitalize' 
vitaminis: vc; 'vitaminise' 
vitiat: vc;attack mkBad vtPer 'vitiate' 
vitrifi: vc;VNPPP chgAttr vt 'vitrify' 
vitrifie: vc;VNPPP chgAttr vt 'vitrify' 
vituperat: vc;VNPPP annoy playDown vt 'vituperate' 
vivifi: vc;chgGood chgState vt 'vivify' 
vivifie: vc;chgGood chgState vt 'vivify' 
vociferat: vc;VPP mkSound 'vociferate' 
voic: vc;VNPPP looks mental soundQua vt 'voice' 
volatilis: vc;statePhy 'volatilise' 
volatiliz: vc;statePhy 'volatilize' 
vomitt: vc;VNPPP artifact nt troubleW vt 'vomit' 
vot: vc;VI VNPPPfor VPP VRB VTH VWHSS VerbNom count tWord vAP vt vtoV 'vote' 
vouche: vc;VPP VPPTH pEmo tWord 'vouch' 
vulcanis: vc;chgAttr control vt 'vulcanise' 
vulcaniz: vc;chgAttr control vt 'vulcanize' 
vulgaris: vc;chgAttr vt 'vulgarise' 
vulgariz: vc;chgAttr demeanor vt 'vulgarize' 
wad: vc;VPP move 'wade' 
wadd: vc;VPP move 'wad' 
waddl: vc;VI VPPdir abstract count vi 'waddle' 
waffl: vc;VPP VPhisNG VerbNom artifact v 'waffle' 
wag: vc;VNPPP abstract artifact count vt 'wage' 
waggl: vc;VNPPP chg vt 'waggle' 
waiv: vc;give vt 'waive' 
wak: vc;VPP count natural vt 'wake' 
wan: vc;VI count statePhy vi 'wane' 
wangl: vc;VNPPNGoc VNPPP abstract count vt 'wangle' 
warbl: vc;count natural nt vt 'warble' 
warehous: vc;artifact count 'warehouse' 
warr: vc;VI VIrecip VPP VPPPP VerbNom 'war' 
washe: vc;VI VNPAP VNPPP VPP VerbNom vt 'wash' 
wast: vc;VNPNGsc VNPPNGsc VNPPP VPP VerbNom natural troubleW vt waste worsen 'waste' 
watche: vc;VNPNG VNPPP VPP VerbNom perOrgV tool useC vVing 'watch' 
waterlogg: vc;worsen 'waterlog' 
waterskii: vc; 'waterski' 
wattl: vc;component v 'wattle' 
wav: vc;VNPPP VPP abstract count natural vt 'wave' 
waxe: vc;chgLooks moreC vAP vt 'wax' 
weav: vc;VNPPPdir VPP VPPdir component count 'weave' 
wedd: vc;VBDN VI VIrecip VNPPP associate vt 'wed' 
wedg: vc;VNPPP count tool 'wedge' 
welche: vc; 'welch' 
welcom: A vc;ATO VNPPP VNPPPas VNPRB VerbNom count pt vt 'welcome' 
welshe: nc vc;VPP origin per 'welsh' 
wenche: vc;count per 'wench' 
westernis: vc;chgAttr vt 'westernise' 
westerniz: vc;chgAttr vt 'westernize' 
wet-nurs: vc;count hyphenated job 'wet-nurse' 
whamm: vc;chgForm 'wham' 
whapp: vc;mkBad 'whap' 
wheedl: vc;VNPPNGoc VNPPP enDo vt 'wheedle' 
wheez: vc;VI count vi 'wheeze' 
whett: vc;chgLooks vt 'whet' 
whin: vc;VPP VTH abstract bad count natural perV vtoV 'whine' 
whipp: vc;VNPPP VPP VPPdir artifact count vt 'whip' 
whistl: vc;VPP artifact count natural vt 'whistle' 
whitewashe: vc;VerbNom vt 'whitewash' 
whittl: vc;VNPPP chgQuant vt 'whittle' 
whopp: vc;mkBad 'whop' 
wiggl: vc;VNPPPdir VNPRB VPPdir VRB count vt 'wiggle' 
wigwagg: vc;enMove 'wigwag' 
wil: vc;abstract count 'wile' 
winc: vc;VI VPP count vi 'wince' 
winche: vc;component count prod tool v 'winch' 
window-shopp: vc;hyphenated move 'window-shop' 
winn: vc;VI VNPPPfor VPP VerbNom count up vt win 'win' 
winteris: vc;act 'winterise' 
winteriz: vc;act 'winterize' 
wip: vc;VNPAP VNPPP VPP count prod vt 'wipe' 
wishe: vc;VNPAP VNPEN VNPNP VNPRB VNPTOoc VPP VPPforTO VSS VTH VerbNom count mental needForW perV purpose stateMental vt vtoV 'wish' 
witnesse: vc;VNPNGoc ness per perOrgV vt 'witness' 
wobbl: vc;VNPRB VPPdir abstract vt 'wobble' 
womanis: vc;vi 'womanise' 
womaniz: vc;VI pAttitude vi 'womanize' 
worri: vc;NV VI VNPPhisNG VPP VPPNG VPhisNG VSS VTH VerbNom annoy problem stateMental vt weakPI worry 'worry' 
worrie: vc;NV VI VNPPhisNG VPP VPPNG VPhisNG VSS VTH VerbNom annoy problem stateMental vt weakPI worry 'worry' 
worshipp: vc;VerbNom stateMental vt 'worship' 
wrangl: vc;VI VIrecip VNPPP VPP VPPPP VPhisNG abstract count 'wrangle' 
wrapp: vc;VNPPP VPP count vt 'wrap' 
wreath: vc;VNPPP enMove 'wreathe' 
wrenche: vc;VNPAP VNPPP count tool vt 'wrench' 
wrestl: vc;VIrecip VNPPP VPP VPPPP count vt 'wrestle' 
wriggl: vc;VNPPP VNPRB VPPdir VRB abstract count vt 'wriggle' 
wrinkl: vc;abstract count natural nt vt 'wrinkle' 
writ: vc;VI VNPPP VNPRB VPP VPPNG VPPas VTH dative express perV produce vt 'write' 
writh: vc;VI VPP move vi whileAway 'writhe' 
xeroxe: vc;count 'xerox' 
yakk: vc;animal count v 'yak' 
yapp: vc;VPP count v 'yap' 
zagh: vc;abstract 'zag' 
zapp: vc;abstract situation vt 'zap' 
zipp: vc;VNPPP VPPdir abstract component vt 'zip' 

